XXXXXXXXXXXXXXXXXXXXXXXXXXXXXXXXXXXXXXXXXXXXXXXXXXXXXXXXXXXXXXXXXXXXXXXXXXXXXXXXXXXXXXXXXXXXXXXXXXXXXXXXXXXXXXXXXXXXXXXXXXXXXXXXXXXXXXXXXXXXXXXXXXXXXXXXXXXXXXXXXXXXXXXXXXXXXXXXXXXXXXXXXXXXXXXXXXXXXXXXXXXXXXXXXXXXXXXXXXXX
----------------[]------[]------[]------[]------[]------[]------[]------[]------[]------[]------[]------[]------[]------[]------[]------[]------[]------[]------[]------[]------[]------[]------[]------[]------[]----------
----------------<>------<>------[]------[]------<>------<>------[]------<>------[]------[]------[]------[]------[]------[]------<>------<>------[]------<>------[]------[]------[]------[]------[]------<>------<>----------
--------------------------------[]------[]----------------------<>--------------<>------[]------<>------<>------[]------<>----------------------<>--------------[]------<>------[]------[]------<>--------------------------
--------------------------------<>------<>----------------------------------------------[]----------------------<>----------------------------------------------<>--------------[]------[]----------------------------------
----------------<>--------------------------------------<>--------------<>--------------<>--------------------------------------<>----------------------------------------------<>------<>----------------------------------
----------------[]------------------------------<>------[]--------------[]------<>----------------------<>----------------------[]------<>------<>----------------------<>--------------------------------------------------
----------------[]------------------------------[]------[]--------------[]------[]----------------------[]--------------<>------[]------[]------[]--------------<>------[]----------------------<>------<>------------------
----------------[]------------------------------[]------[]--------------[]------[]----------------------[]--------------[]------[]------[]------[]--------------[]------[]------<>--------------[]------[]------------------
----------------[]--------------<>--------------[]------[]--------------[]------[]--------------<>------[]------<>------[]------[]------[]------[]--------------[]------[]------[]--------------[]------[]------------------
----------------[]--------------[]--------------[]------[]--------------[]------[]--------------[]------[]------[]------[]------[]------[]------[]--------------[]------[]------[]--------------[]------[]------------------
----------------[]------<>------[]------<>------[]------[]------<>------[]------[]------<>------[]------[]------[]------[]------[]------[]------[]------<>------[]------[]------[]------<>------[]------[]------<>----------
----------------[]------[]------[]------[]------[]------[]------[]------[]------[]------[]------[]------[]------[]------[]------[]------[]------[]------[]------[]------[]------[]------[]------[]------[]------[]----------
XXXXXXXXXXXXXXXXXXXXXXXXXXXXXXXXXXXXXXXXXXXXXXXXXXXXXXXXXXXXXXXXXXXXXXXXXXXXXXXXXXXXXXXXXXXXXXXXXXXXXXXXXXXXXXXXXXXXXXXXXXXXXXXXXXXXXXXXXXXXXXXXXXXXXXXXXXXXXXXXXXXXXXXXXXXXXXXXXXXXXXXXXXXXXXXXXXXXXXXXXXXXXXXXXXXXXXXXXXXX
