XXXXXXXXXXXXXXXXXXXXXXXXXXXXXXXXXXXXXXXXXXXXXXXXXXXXXXXXXXXXXXXXXXXXXXXXXXXXXXXXXXXXXXXXXXXXXXXXXXXXXXXXXXXXXXXXXXXXXXXXXXXXXXXXXXXXXXXXXXXXXXXXXXXXXXXXXXXXXXXXXXXXXXXXXXXXXXXXXXXXXXXXXXXXXXXXXXXXXXXXXXXXXXXXXXXXXXXXXXXX
----------------[]------[]------[]------[]------[]------[]------[]------[]------[]------[]------[]------[]------[]------[]------[]------[]------[]------[]------[]------[]------[]------[]------[]------[]------[]----------
----------------<>------<>------<>------<>------[]------[]------[]------[]------[]------[]------<>------[]------[]------[]------[]------[]------[]------[]------[]------<>------<>------[]------<>------[]------[]----------
------------------------------------------------<>------[]------[]------[]------[]------<>--------------<>------<>------[]------<>------[]------[]------[]------[]----------------------<>--------------[]------<>----------
--------------------------------------------------------<>------[]------<>------<>--------------------------------------<>--------------[]------[]------[]------[]--------------------------------------[]------------------
----------------<>------<>--------------<>----------------------<>----------------------------------------------------------------------[]------<>------[]------[]------<>----------------------<>------[]------------------
----------------[]------[]------<>------[]------<>------------------------------------------------------<>------<>----------------------[]--------------<>------[]------[]----------------------[]------<>------------------
----------------[]------[]------[]------[]------[]------------------------------<>----------------------[]------[]----------------------<>----------------------[]------[]----------------------[]--------------------------
----------------[]------[]------[]------[]------[]--------------<>------<>------[]------<>--------------[]------[]--------------<>--------------<>--------------<>------[]----------------------[]--------------<>----------
----------------[]------[]------[]------[]------[]------<>------[]------[]------[]------[]------<>------[]------[]--------------[]--------------[]----------------------[]------<>--------------[]------<>------[]----------
----------------[]------[]------[]------[]------[]------[]------[]------[]------[]------[]------[]------[]------[]--------------[]--------------[]------<>--------------[]------[]--------------[]------[]------[]----------
----------------[]------[]------[]------[]------[]------[]------[]------[]------[]------[]------[]------[]------[]------<>------[]------<>------[]------[]------<>------[]------[]------<>------[]------[]------[]----------
----------------[]------[]------[]------[]------[]------[]------[]------[]------[]------[]------[]------[]------[]------[]------[]------[]------[]------[]------[]------[]------[]------[]------[]------[]------[]----------
XXXXXXXXXXXXXXXXXXXXXXXXXXXXXXXXXXXXXXXXXXXXXXXXXXXXXXXXXXXXXXXXXXXXXXXXXXXXXXXXXXXXXXXXXXXXXXXXXXXXXXXXXXXXXXXXXXXXXXXXXXXXXXXXXXXXXXXXXXXXXXXXXXXXXXXXXXXXXXXXXXXXXXXXXXXXXXXXXXXXXXXXXXXXXXXXXXXXXXXXXXXXXXXXXXXXXXXXXXXX
