XXXXXXXXXXXXXXXXXXXXXXXXXXXXXXXXXXXXXXXXXXXXXXXXXXXXXXXXXXXXXXXXXXXXXXXXXXXXXXXXXXXXXXXXXXXXXXXXXXXXXXXXXXXXXXXXXXXXXXXXXXXXXXXXXXXXXXXXXXXXXXXXXXXXXXXXXXXXXXXXXXXXXXXXXXXXXXXXXXXXXXXXXXXXXXXXXXXXXXXXXXXXXXXXXXXXXXXXXXXX
----------------[]------[]------[]------[]------[]------[]------[]------[]------[]------[]------[]------[]------[]------[]------[]------[]------[]------[]------[]------[]------[]------[]------[]------[]------[]----------
----------------<>------[]------[]------[]------[]------<>------<>------<>------[]------<>------[]------<>------[]------<>------[]------<>------[]------<>------[]------<>------[]------<>------<>------[]------<>----------
------------------------[]------<>------[]------[]------------------------------[]--------------<>--------------<>--------------<>--------------[]--------------<>--------------<>----------------------<>------------------
------------------------[]--------------[]------<>------------------------------<>--------------------------------------------------------------<>--------------------------------------------------------------------------
----------------<>------<>--------------[]--------------<>------<>------<>--------------<>------------------------------<>--------------------------------------------------------------<>------<>--------------<>----------
----------------[]--------------<>------[]--------------[]------[]------[]--------------[]------<>------<>--------------[]------<>------<>--------------<>----------------------<>------[]------[]--------------[]----------
----------------[]--------------[]------[]------<>------[]------[]------[]--------------[]------[]------[]--------------[]------[]------[]--------------[]--------------<>------[]------[]------[]------<>------[]----------
----------------[]--------------[]------<>------[]------[]------[]------[]--------------[]------[]------[]--------------[]------[]------[]------<>------[]--------------[]------[]------[]------[]------[]------[]----------
----------------[]--------------[]--------------[]------[]------[]------[]--------------[]------[]------[]--------------[]------[]------[]------[]------[]------<>------[]------[]------[]------[]------[]------[]----------
----------------[]--------------[]--------------[]------[]------[]------[]--------------[]------[]------[]------<>------[]------[]------[]------[]------[]------[]------[]------[]------[]------[]------[]------[]----------
----------------[]------<>------[]------<>------[]------[]------[]------[]------<>------[]------[]------[]------[]------[]------[]------[]------[]------[]------[]------[]------[]------[]------[]------[]------[]----------
----------------[]------[]------[]------[]------[]------[]------[]------[]------[]------[]------[]------[]------[]------[]------[]------[]------[]------[]------[]------[]------[]------[]------[]------[]------[]----------
XXXXXXXXXXXXXXXXXXXXXXXXXXXXXXXXXXXXXXXXXXXXXXXXXXXXXXXXXXXXXXXXXXXXXXXXXXXXXXXXXXXXXXXXXXXXXXXXXXXXXXXXXXXXXXXXXXXXXXXXXXXXXXXXXXXXXXXXXXXXXXXXXXXXXXXXXXXXXXXXXXXXXXXXXXXXXXXXXXXXXXXXXXXXXXXXXXXXXXXXXXXXXXXXXXXXXXXXXXXX
