XXXXXXXXXXXXXXXXXXXXXXXXXXXXXXXXXXXXXXXXXXXXXXXXXXXXXXXXXXXXXXXXXXXXXXXXXXXXXXXXXXXXXXXXXXXXXXXXXXXXXXXXXXXXXXXXXXXXXXXXXXXXXXXXXXXXXXXXXXXXXXXXXXXXXXXXXXXXXXXXXXXXXXXXXXXXXXXXXXXXXXXXXXXXXXXXXXXXXXXXXXXXXXXXXXXXXXXXXXXX
----------------[]------[]------[]------[]------[]------[]------[]------[]------[]------[]------[]------[]------[]------[]------[]------[]------[]------[]------[]------[]------[]------[]------[]------[]------[]----------
----------------[]------[]------<>------[]------[]------<>------[]------<>------[]------<>------[]------[]------[]------<>------<>------<>------[]------[]------<>------[]------<>------<>------<>------[]------[]----------
----------------[]------[]--------------[]------<>--------------[]--------------[]--------------<>------[]------<>------------------------------[]------<>--------------[]------------------------------[]------[]----------
----------------[]------[]--------------[]----------------------<>--------------[]----------------------<>--------------------------------------[]----------------------[]------------------------------[]------[]----------
----------------<>------[]--------------<>--------------<>----------------------<>------<>------------------------------------------------------[]----------------------[]--------------<>------<>------[]------<>----------
------------------------[]------------------------------[]------------------------------[]------------------------------<>----------------------[]------<>--------------<>--------------[]------[]------[]------------------
------------------------<>------------------------------[]------<>----------------------[]------------------------------[]----------------------<>------[]------------------------------[]------[]------[]------------------
--------------------------------<>----------------------[]------[]------<>--------------[]------------------------------[]------------------------------[]----------------------<>------[]------[]------<>------------------
--------------------------------[]------<>--------------[]------[]------[]------<>------[]------------------------------[]------------------------------[]------<>--------------[]------[]------[]--------------------------
----------------<>--------------[]------[]------<>------[]------[]------[]------[]------[]------<>------<>------<>------[]------<>--------------<>------[]------[]--------------[]------[]------[]--------------------------
----------------[]------<>------[]------[]------[]------[]------[]------[]------[]------[]------[]------[]------[]------[]------[]------<>------[]------[]------[]------<>------[]------[]------[]------<>------<>----------
----------------[]------[]------[]------[]------[]------[]------[]------[]------[]------[]------[]------[]------[]------[]------[]------[]------[]------[]------[]------[]------[]------[]------[]------[]------[]----------
XXXXXXXXXXXXXXXXXXXXXXXXXXXXXXXXXXXXXXXXXXXXXXXXXXXXXXXXXXXXXXXXXXXXXXXXXXXXXXXXXXXXXXXXXXXXXXXXXXXXXXXXXXXXXXXXXXXXXXXXXXXXXXXXXXXXXXXXXXXXXXXXXXXXXXXXXXXXXXXXXXXXXXXXXXXXXXXXXXXXXXXXXXXXXXXXXXXXXXXXXXXXXXXXXXXXXXXXXXXX
