XXXXXXXXXXXXXXXXXXXXXXXXXXXXXXXXXXXXXXXXXXXXXXXXXXXXXXXXXXXXXXXXXXXXXXXXXXXXXXXXXXXXXXXXXXXXXXXXXXXXXXXXXXXXXXXXXXXXXXXXXXXXXXXXXXXXXXXXXXXXXXXXXXXXXXXXXXXXXXXXXXXXXXXXXXXXXXXXXXXXXXXXXXXXXXXXXXXXXXXXXXXXXXXXXXXXXXXXXXXX
----------------[]------[]------[]------[]------[]------[]------[]------[]------[]------[]------[]------[]------[]------[]------[]------[]------[]------[]------[]------[]------[]------[]------[]------[]------[]----------
----------------<>------[]------[]------[]------<>------<>------[]------[]------<>------<>------<>------<>------[]------<>------[]------<>------<>------<>------[]------[]------<>------[]------<>------[]------[]----------
------------------------<>------[]------<>----------------------<>------[]--------------------------------------[]--------------[]------------------------------<>------[]--------------[]--------------[]------[]----------
--------------------------------<>--------------------------------------<>--------------------------------------[]--------------<>--------------------------------------[]--------------[]--------------[]------[]----------
------------------------------------------------<>------<>----------------------<>----------------------<>------[]------<>----------------------------------------------[]------<>------<>--------------[]------<>----------
------------------------<>----------------------[]------[]------<>--------------[]----------------------[]------<>------[]----------------------------------------------[]------[]----------------------<>------------------
----------------<>------[]--------------<>------[]------[]------[]--------------[]----------------------[]--------------[]------------------------------<>--------------<>------[]------------------------------------------
----------------[]------[]------<>------[]------[]------[]------[]--------------[]----------------------[]--------------[]--------------<>--------------[]----------------------[]------------------------------------------
----------------[]------[]------[]------[]------[]------[]------[]--------------[]------<>------<>------[]--------------[]------<>------[]--------------[]------<>--------------[]------------------------------------------
----------------[]------[]------[]------[]------[]------[]------[]--------------[]------[]------[]------[]--------------[]------[]------[]------<>------[]------[]--------------[]------<>------<>------<>------<>----------
----------------[]------[]------[]------[]------[]------[]------[]------<>------[]------[]------[]------[]------<>------[]------[]------[]------[]------[]------[]------<>------[]------[]------[]------[]------[]----------
----------------[]------[]------[]------[]------[]------[]------[]------[]------[]------[]------[]------[]------[]------[]------[]------[]------[]------[]------[]------[]------[]------[]------[]------[]------[]----------
XXXXXXXXXXXXXXXXXXXXXXXXXXXXXXXXXXXXXXXXXXXXXXXXXXXXXXXXXXXXXXXXXXXXXXXXXXXXXXXXXXXXXXXXXXXXXXXXXXXXXXXXXXXXXXXXXXXXXXXXXXXXXXXXXXXXXXXXXXXXXXXXXXXXXXXXXXXXXXXXXXXXXXXXXXXXXXXXXXXXXXXXXXXXXXXXXXXXXXXXXXXXXXXXXXXXXXXXXXXX
