XXXXXXXXXXXXXXXXXXXXXXXXXXXXXXXXXXXXXXXXXXXXXXXXXXXXXXXXXXXXXXXXXXXXXXXXXXXXXXXXXXXXXXXXXXXXXXXXXXXXXXXXXXXXXXXXXXXXXXXXXXXXXXXXXXXXXXXXXXXXXXXXXXXXXXXXXXXXXXXXXXXXXXXXXXXXXXXXXXXXXXXXXXXXXXXXXXXXXXXXXXXXXXXXXXXXXXXXXXXX
----------------[]------[]------[]------[]------[]------[]------[]------[]------[]------[]------[]------[]------[]------[]------[]------[]------[]------[]------[]------[]------[]------[]------[]------[]------[]----------
----------------<>------[]------<>------[]------<>------[]------[]------[]------<>------[]------<>------<>------<>------<>------[]------<>------[]------[]------<>------[]------[]------[]------[]------[]------<>----------
------------------------<>--------------[]--------------[]------[]------[]--------------<>--------------------------------------[]--------------[]------[]--------------<>------<>------[]------<>------<>------------------
----------------------------------------<>--------------[]------<>------[]------------------------------------------------------[]--------------<>------[]------------------------------[]----------------------------------
--------------------------------------------------------[]--------------<>--------------------------------------<>--------------[]----------------------[]------<>----------------------<>----------------------------------
----------------<>--------------<>----------------------[]--------------------------------------<>--------------[]--------------<>----------------------<>------[]--------------<>------------------------------------------
----------------[]------<>------[]------<>--------------<>--------------------------------------[]------<>------[]------------------------------<>--------------[]------<>------[]--------------<>--------------------------
----------------[]------[]------[]------[]------------------------------------------------------[]------[]------[]----------------------<>------[]--------------[]------[]------[]--------------[]--------------------------
----------------[]------[]------[]------[]------------------------------<>----------------------[]------[]------[]--------------<>------[]------[]------<>------[]------[]------[]--------------[]--------------<>----------
----------------[]------[]------[]------[]--------------<>--------------[]------<>--------------[]------[]------[]------<>------[]------[]------[]------[]------[]------[]------[]--------------[]------<>------[]----------
----------------[]------[]------[]------[]------<>------[]------<>------[]------[]------<>------[]------[]------[]------[]------[]------[]------[]------[]------[]------[]------[]------<>------[]------[]------[]----------
----------------[]------[]------[]------[]------[]------[]------[]------[]------[]------[]------[]------[]------[]------[]------[]------[]------[]------[]------[]------[]------[]------[]------[]------[]------[]----------
XXXXXXXXXXXXXXXXXXXXXXXXXXXXXXXXXXXXXXXXXXXXXXXXXXXXXXXXXXXXXXXXXXXXXXXXXXXXXXXXXXXXXXXXXXXXXXXXXXXXXXXXXXXXXXXXXXXXXXXXXXXXXXXXXXXXXXXXXXXXXXXXXXXXXXXXXXXXXXXXXXXXXXXXXXXXXXXXXXXXXXXXXXXXXXXXXXXXXXXXXXXXXXXXXXXXXXXXXXXX
