XXXXXXXXXXXXXXXXXXXXXXXXXXXXXXXXXXXXXXXXXXXXXXXXXXXXXXXXXXXXXXXXXXXXXXXXXXXXXXXXXXXXXXXXXXXXXXXXXXXXXXXXXXXXXXXXXXXXXXXXXXXXXXXXXXXXXXXXXXXXXXXXXXXXXXXXXXXXXXXXXXXXXXXXXXXXXXXXXXXXXXXXXXXXXXXXXXXXXXXXXXXXXXXXXXXXXXXXXXXX
----------------[]------[]------[]------[]------[]------[]------[]------[]------[]------[]------[]------[]------[]------[]------[]------[]------[]------[]------[]------[]------[]------[]------[]------[]------[]----------
----------------<>------<>------[]------[]------[]------<>------[]------[]------[]------<>------<>------<>------[]------<>------[]------<>------[]------[]------[]------<>------<>------<>------<>------<>------[]----------
--------------------------------[]------<>------<>--------------<>------[]------[]------------------------------[]--------------[]--------------[]------[]------[]----------------------------------------------<>----------
--------------------------------[]--------------------------------------[]------<>------------------------------<>--------------[]--------------<>------[]------[]----------------------------------------------------------
----------------<>------<>------<>----------------------<>--------------<>------------------------------<>----------------------[]------<>--------------[]------<>----------------------<>------<>------<>------------------
----------------[]------[]--------------<>------<>------[]------------------------------<>------<>------[]----------------------[]------[]--------------<>----------------------<>------[]------[]------[]------------------
----------------[]------[]--------------[]------[]------[]------------------------------[]------[]------[]------<>--------------[]------[]------<>------------------------------[]------[]------[]------[]------<>----------
----------------[]------[]--------------[]------[]------[]------------------------------[]------[]------[]------[]--------------<>------[]------[]--------------<>--------------[]------[]------[]------[]------[]----------
----------------[]------[]--------------[]------[]------[]--------------<>------<>------[]------[]------[]------[]----------------------[]------[]------<>------[]------<>------[]------[]------[]------[]------[]----------
----------------[]------[]------<>------[]------[]------[]--------------[]------[]------[]------[]------[]------[]------<>--------------[]------[]------[]------[]------[]------[]------[]------[]------[]------[]----------
----------------[]------[]------[]------[]------[]------[]------<>------[]------[]------[]------[]------[]------[]------[]------<>------[]------[]------[]------[]------[]------[]------[]------[]------[]------[]----------
----------------[]------[]------[]------[]------[]------[]------[]------[]------[]------[]------[]------[]------[]------[]------[]------[]------[]------[]------[]------[]------[]------[]------[]------[]------[]----------
XXXXXXXXXXXXXXXXXXXXXXXXXXXXXXXXXXXXXXXXXXXXXXXXXXXXXXXXXXXXXXXXXXXXXXXXXXXXXXXXXXXXXXXXXXXXXXXXXXXXXXXXXXXXXXXXXXXXXXXXXXXXXXXXXXXXXXXXXXXXXXXXXXXXXXXXXXXXXXXXXXXXXXXXXXXXXXXXXXXXXXXXXXXXXXXXXXXXXXXXXXXXXXXXXXXXXXXXXXXX
