XXXXXXXXXXXXXXXXXXXXXXXXXXXXXXXXXXXXXXXXXXXXXXXXXXXXXXXXXXXXXXXXXXXXXXXXXXXXXXXXXXXXXXXXXXXXXXXXXXXXXXXXXXXXXXXXXXXXXXXXXXXXXXXXXXXXXXXXXXXXXXXXXXXXXXXXXXXXXXXXXXXXXXXXXXXXXXXXXXXXXXXXXXXXXXXXXXXXXXXXXXXXXXXXXXXXXXXXXXXX
----------------[]------[]------[]------[]------[]------[]------[]------[]------[]------[]------[]------[]------[]------[]------[]------[]------[]------[]------[]------[]------[]------[]------[]------[]------[]----------
----------------[]------<>------<>------[]------<>------[]------[]------[]------<>------[]------<>------[]------<>------<>------[]------[]------<>------[]------<>------<>------[]------[]------[]------[]------<>----------
----------------[]----------------------[]--------------[]------<>------<>--------------<>--------------[]----------------------[]------<>--------------<>----------------------[]------[]------<>------<>------------------
----------------[]----------------------[]--------------<>----------------------------------------------[]----------------------<>----------------------------------------------[]------[]----------------------------------
----------------<>----------------------[]------<>------------------------------------------------------[]--------------------------------------------------------------<>------[]------[]----------------------<>----------
----------------------------------------<>------[]----------------------<>------------------------------<>--------------------------------------<>------<>------<>------[]------[]------[]--------------<>------[]----------
--------------------------------<>--------------[]----------------------[]--------------------------------------<>------------------------------[]------[]------[]------[]------<>------<>--------------[]------[]----------
----------------<>--------------[]--------------[]--------------<>------[]------<>------------------------------[]------------------------------[]------[]------[]------[]------------------------------[]------[]----------
----------------[]--------------[]------<>------[]--------------[]------[]------[]--------------<>--------------[]--------------<>------<>------[]------[]------[]------[]------------------------------[]------[]----------
----------------[]--------------[]------[]------[]------<>------[]------[]------[]------<>------[]------<>------[]------<>------[]------[]------[]------[]------[]------[]------<>------<>--------------[]------[]----------
----------------[]------<>------[]------[]------[]------[]------[]------[]------[]------[]------[]------[]------[]------[]------[]------[]------[]------[]------[]------[]------[]------[]------<>------[]------[]----------
----------------[]------[]------[]------[]------[]------[]------[]------[]------[]------[]------[]------[]------[]------[]------[]------[]------[]------[]------[]------[]------[]------[]------[]------[]------[]----------
XXXXXXXXXXXXXXXXXXXXXXXXXXXXXXXXXXXXXXXXXXXXXXXXXXXXXXXXXXXXXXXXXXXXXXXXXXXXXXXXXXXXXXXXXXXXXXXXXXXXXXXXXXXXXXXXXXXXXXXXXXXXXXXXXXXXXXXXXXXXXXXXXXXXXXXXXXXXXXXXXXXXXXXXXXXXXXXXXXXXXXXXXXXXXXXXXXXXXXXXXXXXXXXXXXXXXXXXXXXX
