XXXXXXXXXXXXXXXXXXXXXXXXXXXXXXXXXXXXXXXXXXXXXXXXXXXXXXXXXXXXXXXXXXXXXXXXXXXXXXXXXXXXXXXXXXXXXXXXXXXXXXXXXXXXXXXXXXXXXXXXXXXXXXXXXXXXXXXXXXXXXXXXXXXXXXXXXXXXXXXXXXXXXXXXXXXXXXXXXXXXXXXXXXXXXXXXXXXXXXXXXXXXXXXXXXXXXXXXXXXX
----------------[]------[]------[]------[]------[]------[]------[]------[]------[]------[]------[]------[]------[]------[]------[]------[]------[]------[]------[]------[]------[]------[]------[]------[]------[]----------
----------------[]------<>------[]------[]------<>------[]------[]------[]------<>------[]------<>------[]------[]------[]------[]------<>------[]------<>------[]------<>------[]------<>------<>------[]------[]----------
----------------<>--------------[]------[]--------------[]------[]------<>--------------[]--------------<>------[]------<>------[]--------------<>--------------<>--------------[]----------------------[]------[]----------
--------------------------------[]------[]--------------[]------<>----------------------[]----------------------[]--------------<>----------------------------------------------<>----------------------<>------[]----------
------------------------<>------<>------<>--------------[]------------------------------[]----------------------[]------------------------------------------------------<>--------------<>------<>--------------[]----------
------------------------[]----------------------<>------<>----------------------<>------<>--------------<>------<>----------------------------------------------<>------[]--------------[]------[]--------------<>----------
------------------------[]----------------------[]------------------------------[]--------------<>------[]--------------<>------<>--------------<>------<>------[]------[]------<>------[]------[]--------------------------
------------------------[]----------------------[]------------------------------[]--------------[]------[]--------------[]------[]--------------[]------[]------[]------[]------[]------[]------[]--------------------------
------------------------[]--------------<>------[]------------------------------[]--------------[]------[]------<>------[]------[]------<>------[]------[]------[]------[]------[]------[]------[]--------------------------
------------------------[]------<>------[]------[]----------------------<>------[]--------------[]------[]------[]------[]------[]------[]------[]------[]------[]------[]------[]------[]------[]------<>------------------
----------------<>------[]------[]------[]------[]------<>------<>------[]------[]------<>------[]------[]------[]------[]------[]------[]------[]------[]------[]------[]------[]------[]------[]------[]------<>----------
----------------[]------[]------[]------[]------[]------[]------[]------[]------[]------[]------[]------[]------[]------[]------[]------[]------[]------[]------[]------[]------[]------[]------[]------[]------[]----------
XXXXXXXXXXXXXXXXXXXXXXXXXXXXXXXXXXXXXXXXXXXXXXXXXXXXXXXXXXXXXXXXXXXXXXXXXXXXXXXXXXXXXXXXXXXXXXXXXXXXXXXXXXXXXXXXXXXXXXXXXXXXXXXXXXXXXXXXXXXXXXXXXXXXXXXXXXXXXXXXXXXXXXXXXXXXXXXXXXXXXXXXXXXXXXXXXXXXXXXXXXXXXXXXXXXXXXXXXXXX
