XXXXXXXXXXXXXXXXXXXXXXXXXXXXXXXXXXXXXXXXXXXXXXXXXXXXXXXXXXXXXXXXXXXXXXXXXXXXXXXXXXXXXXXXXXXXXXXXXXXXXXXXXXXXXXXXXXXXXXXXXXXXXXXXXXXXXXXXXXXXXXXXXXXXXXXXXXXXXXXXXXXXXXXXXXXXXXXXXXXXXXXXXXXXXXXXXXXXXXXXXXXXXXXXXXXXXXXXXXXX
----------------[]------[]------[]------[]------[]------[]------[]------[]------[]------[]------[]------[]------[]------[]------[]------[]------[]------[]------[]------[]------[]------[]------[]------[]------[]----------
----------------[]------[]------[]------[]------[]------<>------[]------[]------[]------[]------[]------<>------<>------<>------[]------[]------<>------<>------[]------[]------[]------<>------[]------<>------[]----------
----------------[]------<>------<>------[]------[]--------------<>------[]------<>------[]------[]------------------------------<>------[]----------------------<>------<>------[]--------------[]--------------<>----------
----------------[]----------------------[]------[]----------------------[]--------------[]------<>--------------------------------------<>--------------------------------------<>--------------<>--------------------------
----------------[]----------------------<>------[]----------------------[]--------------[]----------------------<>----------------------------------------------------------------------------------------------------------
----------------[]------<>----------------------[]----------------------<>--------------[]----------------------[]------<>--------------------------------------<>------<>------------------------------<>------------------
----------------<>------[]------<>--------------<>------<>------<>----------------------<>----------------------[]------[]------<>------------------------------[]------[]------<>----------------------[]------------------
------------------------[]------[]------<>--------------[]------[]--------------<>------------------------------[]------[]------[]------------------------------[]------[]------[]----------------------[]------<>----------
------------------------[]------[]------[]--------------[]------[]--------------[]--------------<>------<>------[]------[]------[]------<>----------------------[]------[]------[]------<>------<>------[]------[]----------
----------------<>------[]------[]------[]------<>------[]------[]--------------[]--------------[]------[]------[]------[]------[]------[]------<>--------------[]------[]------[]------[]------[]------[]------[]----------
----------------[]------[]------[]------[]------[]------[]------[]------<>------[]------<>------[]------[]------[]------[]------[]------[]------[]------<>------[]------[]------[]------[]------[]------[]------[]----------
----------------[]------[]------[]------[]------[]------[]------[]------[]------[]------[]------[]------[]------[]------[]------[]------[]------[]------[]------[]------[]------[]------[]------[]------[]------[]----------
XXXXXXXXXXXXXXXXXXXXXXXXXXXXXXXXXXXXXXXXXXXXXXXXXXXXXXXXXXXXXXXXXXXXXXXXXXXXXXXXXXXXXXXXXXXXXXXXXXXXXXXXXXXXXXXXXXXXXXXXXXXXXXXXXXXXXXXXXXXXXXXXXXXXXXXXXXXXXXXXXXXXXXXXXXXXXXXXXXXXXXXXXXXXXXXXXXXXXXXXXXXXXXXXXXXXXXXXXXXX
