XXXXXXXXXXXXXXXXXXXXXXXXXXXXXXXXXXXXXXXXXXXXXXXXXXXXXXXXXXXXXXXXXXXXXXXXXXXXXXXXXXXXXXXXXXXXXXXXXXXXXXXXXXXXXXXXXXXXXXXXXXXXXXXXXXXXXXXXXXXXXXXXXXXXXXXXXXXXXXXXXXXXXXXXXXXXXXXXXXXXXXXXXXXXXXXXXXXXXXXXXXXXXXXXXXXXXXXXXXXX
----------------[]------[]------[]------[]------[]------[]------[]------[]------[]------[]------[]------[]------[]------[]------[]------[]------[]------[]------[]------[]------[]------[]------[]------[]------[]----------
----------------<>------<>------[]------[]------[]------[]------<>------<>------[]------[]------<>------<>------[]------<>------[]------[]------[]------[]------[]------[]------[]------<>------<>------[]------<>----------
--------------------------------<>------<>------<>------[]----------------------<>------[]----------------------<>--------------[]------[]------[]------[]------<>------[]------[]----------------------[]------------------
--------------------------------------------------------[]------------------------------[]--------------------------------------<>------<>------[]------[]--------------<>------[]----------------------<>------------------
----------------<>--------------------------------------<>------------------------------[]--------------<>--------------<>----------------------<>------<>----------------------<>--------------<>--------------<>----------
----------------[]------<>------<>------------------------------<>--------------<>------[]--------------[]--------------[]--------------------------------------------------------------<>------[]--------------[]----------
----------------[]------[]------[]--------------<>--------------[]--------------[]------<>--------------[]--------------[]--------------------------------------<>------<>--------------[]------[]--------------[]----------
----------------[]------[]------[]--------------[]--------------[]--------------[]----------------------[]--------------[]--------------<>--------------<>------[]------[]------<>------[]------[]------<>------[]----------
----------------[]------[]------[]------<>------[]--------------[]------<>------[]----------------------[]--------------[]--------------[]--------------[]------[]------[]------[]------[]------[]------[]------[]----------
----------------[]------[]------[]------[]------[]--------------[]------[]------[]------<>--------------[]--------------[]------<>------[]------<>------[]------[]------[]------[]------[]------[]------[]------[]----------
----------------[]------[]------[]------[]------[]------<>------[]------[]------[]------[]------<>------[]------<>------[]------[]------[]------[]------[]------[]------[]------[]------[]------[]------[]------[]----------
----------------[]------[]------[]------[]------[]------[]------[]------[]------[]------[]------[]------[]------[]------[]------[]------[]------[]------[]------[]------[]------[]------[]------[]------[]------[]----------
XXXXXXXXXXXXXXXXXXXXXXXXXXXXXXXXXXXXXXXXXXXXXXXXXXXXXXXXXXXXXXXXXXXXXXXXXXXXXXXXXXXXXXXXXXXXXXXXXXXXXXXXXXXXXXXXXXXXXXXXXXXXXXXXXXXXXXXXXXXXXXXXXXXXXXXXXXXXXXXXXXXXXXXXXXXXXXXXXXXXXXXXXXXXXXXXXXXXXXXXXXXXXXXXXXXXXXXXXXXX
