XXXXXXXXXXXXXXXXXXXXXXXXXXXXXXXXXXXXXXXXXXXXXXXXXXXXXXXXXXXXXXXXXXXXXXXXXXXXXXXXXXXXXXXXXXXXXXXXXXXXXXXXXXXXXXXXXXXXXXXXXXXXXXXXXXXXXXXXXXXXXXXXXXXXXXXXXXXXXXXXXXXXXXXXXXXXXXXXXXXXXXXXXXXXXXXXXXXXXXXXXXXXXXXXXXXXXXXXXXXX
----------------[]------[]------[]------[]------[]------[]------[]------[]------[]------[]------[]------[]------[]------[]------[]------[]------[]------[]------[]------[]------[]------[]------[]------[]------[]----------
----------------[]------[]------[]------[]------<>------<>------[]------[]------[]------[]------[]------<>------<>------[]------[]------[]------<>------[]------<>------[]------<>------[]------[]------[]------<>----------
----------------[]------[]------[]------<>----------------------<>------[]------<>------[]------[]----------------------[]------[]------[]--------------<>--------------<>--------------<>------[]------[]------------------
----------------[]------[]------[]--------------------------------------<>--------------<>------[]----------------------[]------<>------[]------------------------------------------------------<>------[]------------------
----------------[]------<>------<>--------------<>----------------------------------------------<>----------------------[]--------------[]------<>--------------<>--------------<>----------------------[]------<>----------
----------------[]------------------------------[]--------------------------------------------------------------<>------[]--------------[]------[]--------------[]--------------[]------<>--------------<>------[]----------
----------------<>------------------------------[]------<>----------------------<>------<>----------------------[]------<>--------------<>------[]--------------[]--------------[]------[]----------------------[]----------
--------------------------------<>--------------[]------[]----------------------[]------[]----------------------[]------------------------------[]--------------[]------<>------[]------[]------<>--------------[]----------
--------------------------------[]--------------[]------[]--------------<>------[]------[]------<>--------------[]--------------<>--------------[]--------------[]------[]------[]------[]------[]--------------[]----------
--------------------------------[]------<>------[]------[]------<>------[]------[]------[]------[]--------------[]------<>------[]------<>------[]------<>------[]------[]------[]------[]------[]------<>------[]----------
----------------<>------<>------[]------[]------[]------[]------[]------[]------[]------[]------[]------<>------[]------[]------[]------[]------[]------[]------[]------[]------[]------[]------[]------[]------[]----------
----------------[]------[]------[]------[]------[]------[]------[]------[]------[]------[]------[]------[]------[]------[]------[]------[]------[]------[]------[]------[]------[]------[]------[]------[]------[]----------
XXXXXXXXXXXXXXXXXXXXXXXXXXXXXXXXXXXXXXXXXXXXXXXXXXXXXXXXXXXXXXXXXXXXXXXXXXXXXXXXXXXXXXXXXXXXXXXXXXXXXXXXXXXXXXXXXXXXXXXXXXXXXXXXXXXXXXXXXXXXXXXXXXXXXXXXXXXXXXXXXXXXXXXXXXXXXXXXXXXXXXXXXXXXXXXXXXXXXXXXXXXXXXXXXXXXXXXXXXXX
