XXXXXXXXXXXXXXXXXXXXXXXXXXXXXXXXXXXXXXXXXXXXXXXXXXXXXXXXXXXXXXXXXXXXXXXXXXXXXXXXXXXXXXXXXXXXXXXXXXXXXXXXXXXXXXXXXXXXXXXXXXXXXXXXXXXXXXXXXXXXXXXXXXXXXXXXXXXXXXXXXXXXXXXXXXXXXXXXXXXXXXXXXXXXXXXXXXXXXXXXXXXXXXXXXXXXXXXXXXXX
----------------[]------[]------[]------[]------[]------[]------[]------[]------[]------[]------[]------[]------[]------[]------[]------[]------[]------[]------[]------[]------[]------[]------[]------[]------[]----------
----------------[]------<>------<>------<>------<>------<>------<>------[]------<>------[]------<>------[]------<>------[]------<>------[]------<>------[]------<>------[]------[]------[]------[]------<>------<>----------
----------------<>------------------------------------------------------[]--------------[]--------------<>--------------[]--------------[]--------------[]--------------[]------[]------<>------<>--------------------------
------------------------------------------------------------------------<>--------------<>------------------------------[]--------------<>--------------[]--------------[]------[]------------------------------------------
------------------------<>--------------<>--------------<>----------------------<>--------------<>--------------<>------[]------<>----------------------[]--------------[]------<>------------------------------------------
----------------<>------[]------<>------[]--------------[]----------------------[]--------------[]--------------[]------[]------[]----------------------<>------<>------[]--------------------------------------------------
----------------[]------[]------[]------[]--------------[]------<>------<>------[]--------------[]------<>------[]------<>------[]--------------<>--------------[]------[]------------------------------<>------<>----------
----------------[]------[]------[]------[]--------------[]------[]------[]------[]------<>------[]------[]------[]--------------[]------<>------[]--------------[]------<>------------------------------[]------[]----------
----------------[]------[]------[]------[]--------------[]------[]------[]------[]------[]------[]------[]------[]--------------[]------[]------[]--------------[]--------------------------------------[]------[]----------
----------------[]------[]------[]------[]--------------[]------[]------[]------[]------[]------[]------[]------[]------<>------[]------[]------[]------<>------[]--------------<>------<>--------------[]------[]----------
----------------[]------[]------[]------[]------<>------[]------[]------[]------[]------[]------[]------[]------[]------[]------[]------[]------[]------[]------[]------<>------[]------[]------<>------[]------[]----------
----------------[]------[]------[]------[]------[]------[]------[]------[]------[]------[]------[]------[]------[]------[]------[]------[]------[]------[]------[]------[]------[]------[]------[]------[]------[]----------
XXXXXXXXXXXXXXXXXXXXXXXXXXXXXXXXXXXXXXXXXXXXXXXXXXXXXXXXXXXXXXXXXXXXXXXXXXXXXXXXXXXXXXXXXXXXXXXXXXXXXXXXXXXXXXXXXXXXXXXXXXXXXXXXXXXXXXXXXXXXXXXXXXXXXXXXXXXXXXXXXXXXXXXXXXXXXXXXXXXXXXXXXXXXXXXXXXXXXXXXXXXXXXXXXXXXXXXXXXXX
