XXXXXXXXXXXXXXXXXXXXXXXXXXXXXXXXXXXXXXXXXXXXXXXXXXXXXXXXXXXXXXXXXXXXXXXXXXXXXXXXXXXXXXXXXXXXXXXXXXXXXXXXXXXXXXXXXXXXXXXXXXXXXXXXXXXXXXXXXXXXXXXXXXXXXXXXXXXXXXXXXXXXXXXXXXXXXXXXXXXXXXXXXXXXXXXXXXXXXXXXXXXXXXXXXXXXXXXXXXXX
----------------[]------[]------[]------[]------[]------[]------[]------[]------[]------[]------[]------[]------[]------[]------[]------[]------[]------[]------[]------[]------[]------[]------[]------[]------[]----------
----------------[]------<>------[]------[]------<>------[]------[]------[]------[]------[]------<>------[]------[]------[]------[]------<>------[]------[]------<>------[]------[]------[]------<>------<>------[]----------
----------------[]--------------[]------[]--------------<>------<>------[]------<>------[]--------------<>------[]------[]------<>--------------<>------[]--------------<>------[]------<>----------------------[]----------
----------------[]--------------[]------[]------------------------------<>--------------[]----------------------<>------<>------------------------------<>----------------------<>------------------------------<>----------
----------------[]--------------[]------<>------<>--------------------------------------[]------<>--------------------------------------<>----------------------------------------------------------------------------------
----------------[]------<>------[]--------------[]------<>------<>--------------<>------<>------[]--------------------------------------[]------------------------------<>--------------<>------<>------<>------------------
----------------[]------[]------[]--------------[]------[]------[]------<>------[]--------------[]--------------------------------------[]----------------------<>------[]------<>------[]------[]------[]------------------
----------------<>------[]------<>------<>------[]------[]------[]------[]------[]--------------[]--------------------------------------[]------<>--------------[]------[]------[]------[]------[]------[]------------------
------------------------[]--------------[]------[]------[]------[]------[]------[]------<>------[]--------------<>--------------<>------[]------[]--------------[]------[]------[]------[]------[]------[]------<>----------
------------------------[]--------------[]------[]------[]------[]------[]------[]------[]------[]------<>------[]------<>------[]------[]------[]------<>------[]------[]------[]------[]------[]------[]------[]----------
----------------<>------[]------<>------[]------[]------[]------[]------[]------[]------[]------[]------[]------[]------[]------[]------[]------[]------[]------[]------[]------[]------[]------[]------[]------[]----------
----------------[]------[]------[]------[]------[]------[]------[]------[]------[]------[]------[]------[]------[]------[]------[]------[]------[]------[]------[]------[]------[]------[]------[]------[]------[]----------
XXXXXXXXXXXXXXXXXXXXXXXXXXXXXXXXXXXXXXXXXXXXXXXXXXXXXXXXXXXXXXXXXXXXXXXXXXXXXXXXXXXXXXXXXXXXXXXXXXXXXXXXXXXXXXXXXXXXXXXXXXXXXXXXXXXXXXXXXXXXXXXXXXXXXXXXXXXXXXXXXXXXXXXXXXXXXXXXXXXXXXXXXXXXXXXXXXXXXXXXXXXXXXXXXXXXXXXXXXXX
