XXXXXXXXXXXXXXXXXXXXXXXXXXXXXXXXXXXXXXXXXXXXXXXXXXXXXXXXXXXXXXXXXXXXXXXXXXXXXXXXXXXXXXXXXXXXXXXXXXXXXXXXXXXXXXXXXXXXXXXXXXXXXXXXXXXXXXXXXXXXXXXXXXXXXXXXXXXXXXXXXXXXXXXXXXXXXXXXXXXXXXXXXXXXXXXXXXXXXXXXXXXXXXXXXXXXXXXXXXXX
----------------[]------[]------[]------[]------[]------[]------[]------[]------[]------[]------[]------[]------[]------[]------[]------[]------[]------[]------[]------[]------[]------[]------[]------[]------[]----------
----------------[]------<>------[]------[]------[]------[]------<>------[]------[]------[]------[]------[]------<>------[]------[]------[]------[]------[]------<>------[]------<>------[]------<>------<>------[]----------
----------------<>--------------<>------[]------<>------[]--------------[]------<>------[]------<>------<>--------------[]------<>------<>------[]------[]--------------<>--------------[]----------------------<>----------
----------------------------------------[]--------------<>--------------<>--------------[]------------------------------[]----------------------[]------[]------------------------------<>----------------------------------
----------------------------------------<>----------------------------------------------[]------------------------------<>----------------------<>------<>--------------------------------------<>------<>------------------
--------------------------------<>--------------<>--------------------------------------<>------<>------<>------------------------------<>------------------------------<>----------------------[]------[]------<>----------
--------------------------------[]--------------[]------<>--------------------------------------[]------[]------<>----------------------[]------------------------------[]------<>--------------[]------[]------[]----------
------------------------<>------[]--------------[]------[]--------------<>----------------------[]------[]------[]----------------------[]------<>--------------<>------[]------[]------<>------[]------[]------[]----------
------------------------[]------[]--------------[]------[]--------------[]----------------------[]------[]------[]----------------------[]------[]------<>------[]------[]------[]------[]------[]------[]------[]----------
------------------------[]------[]------<>------[]------[]------<>------[]------<>--------------[]------[]------[]------<>------<>------[]------[]------[]------[]------[]------[]------[]------[]------[]------[]----------
----------------<>------[]------[]------[]------[]------[]------[]------[]------[]------<>------[]------[]------[]------[]------[]------[]------[]------[]------[]------[]------[]------[]------[]------[]------[]----------
----------------[]------[]------[]------[]------[]------[]------[]------[]------[]------[]------[]------[]------[]------[]------[]------[]------[]------[]------[]------[]------[]------[]------[]------[]------[]----------
XXXXXXXXXXXXXXXXXXXXXXXXXXXXXXXXXXXXXXXXXXXXXXXXXXXXXXXXXXXXXXXXXXXXXXXXXXXXXXXXXXXXXXXXXXXXXXXXXXXXXXXXXXXXXXXXXXXXXXXXXXXXXXXXXXXXXXXXXXXXXXXXXXXXXXXXXXXXXXXXXXXXXXXXXXXXXXXXXXXXXXXXXXXXXXXXXXXXXXXXXXXXXXXXXXXXXXXXXXXX
