XXXXXXXXXXXXXXXXXXXXXXXXXXXXXXXXXXXXXXXXXXXXXXXXXXXXXXXXXXXXXXXXXXXXXXXXXXXXXXXXXXXXXXXXXXXXXXXXXXXXXXXXXXXXXXXXXXXXXXXXXXXXXXXXXXXXXXXXXXXXXXXXXXXXXXXXXXXXXXXXXXXXXXXXXXXXXXXXXXXXXXXXXXXXXXXXXXXXXXXXXXXXXXXXXXXXXXXXXXXX
----------------[]------[]------[]------[]------[]------[]------[]------[]------[]------[]------[]------[]------[]------[]------[]------[]------[]------[]------[]------[]------[]------[]------[]------[]------[]----------
----------------[]------[]------<>------[]------[]------<>------<>------<>------<>------[]------[]------[]------[]------[]------[]------[]------<>------[]------<>------[]------[]------[]------[]------[]------<>----------
----------------[]------[]--------------[]------<>--------------------------------------[]------[]------[]------[]------[]------[]------[]--------------[]--------------<>------[]------[]------[]------[]------------------
----------------<>------[]--------------[]----------------------------------------------<>------<>------<>------<>------[]------[]------<>--------------<>----------------------[]------<>------[]------[]------------------
------------------------<>--------------[]--------------<>--------------------------------------------------------------[]------[]----------------------------------------------<>--------------[]------<>------------------
----------------------------------------[]------<>------[]--------------------------------------------------------------[]------<>--------------<>----------------------------------------------<>--------------------------
----------------------------------------<>------[]------[]--------------<>------------------------------<>--------------[]--------------<>------[]--------------------------------------<>----------------------------------
----------------<>--------------<>--------------[]------[]------<>------[]------<>------<>--------------[]--------------<>--------------[]------[]------<>------<>------<>--------------[]--------------<>------<>----------
----------------[]------<>------[]--------------[]------[]------[]------[]------[]------[]--------------[]------<>--------------<>------[]------[]------[]------[]------[]------<>------[]--------------[]------[]----------
----------------[]------[]------[]------<>------[]------[]------[]------[]------[]------[]------<>------[]------[]--------------[]------[]------[]------[]------[]------[]------[]------[]--------------[]------[]----------
----------------[]------[]------[]------[]------[]------[]------[]------[]------[]------[]------[]------[]------[]------<>------[]------[]------[]------[]------[]------[]------[]------[]------<>------[]------[]----------
----------------[]------[]------[]------[]------[]------[]------[]------[]------[]------[]------[]------[]------[]------[]------[]------[]------[]------[]------[]------[]------[]------[]------[]------[]------[]----------
XXXXXXXXXXXXXXXXXXXXXXXXXXXXXXXXXXXXXXXXXXXXXXXXXXXXXXXXXXXXXXXXXXXXXXXXXXXXXXXXXXXXXXXXXXXXXXXXXXXXXXXXXXXXXXXXXXXXXXXXXXXXXXXXXXXXXXXXXXXXXXXXXXXXXXXXXXXXXXXXXXXXXXXXXXXXXXXXXXXXXXXXXXXXXXXXXXXXXXXXXXXXXXXXXXXXXXXXXXXX
