XXXXXXXXXXXXXXXXXXXXXXXXXXXXXXXXXXXXXXXXXXXXXXXXXXXXXXXXXXXXXXXXXXXXXXXXXXXXXXXXXXXXXXXXXXXXXXXXXXXXXXXXXXXXXXXXXXXXXXXXXXXXXXXXXXXXXXXXXXXXXXXXXXXXXXXXXXXXXXXXXXXXXXXXXXXXXXXXXXXXXXXXXXXXXXXXXXXXXXXXXXXXXXXXXXXXXXXXXXXX
----------------[]------[]------[]------[]------[]------[]------[]------[]------[]------[]------[]------[]------[]------[]------[]------[]------[]------[]------[]------[]------[]------[]------[]------[]------[]----------
----------------[]------[]------[]------[]------[]------[]------[]------[]------<>------[]------<>------<>------[]------<>------[]------[]------[]------[]------[]------[]------[]------[]------<>------<>------[]----------
----------------[]------[]------<>------<>------[]------<>------[]------<>--------------[]----------------------[]--------------<>------<>------<>------[]------[]------[]------[]------<>----------------------<>----------
----------------<>------[]----------------------[]--------------[]----------------------[]----------------------[]--------------------------------------[]------[]------[]------[]------------------------------------------
------------------------[]----------------------[]--------------[]----------------------<>----------------------[]--------------------------------------[]------[]------<>------<>--------------<>------<>------------------
------------------------<>--------------<>------<>--------------<>----------------------------------------------<>------<>------<>--------------<>------[]------<>----------------------<>------[]------[]------------------
----------------------------------------[]--------------------------------------<>--------------<>----------------------[]------[]--------------[]------<>------------------------------[]------[]------[]------------------
----------------------------------------[]--------------<>--------------<>------[]--------------[]----------------------[]------[]--------------[]----------------------<>------<>------[]------[]------[]------------------
------------------------<>------<>------[]--------------[]--------------[]------[]------<>------[]----------------------[]------[]--------------[]----------------------[]------[]------[]------[]------[]------------------
----------------<>------[]------[]------[]--------------[]--------------[]------[]------[]------[]------<>--------------[]------[]--------------[]----------------------[]------[]------[]------[]------[]------------------
----------------[]------[]------[]------[]------<>------[]------<>------[]------[]------[]------[]------[]------<>------[]------[]------<>------[]------<>------<>------[]------[]------[]------[]------[]------<>----------
----------------[]------[]------[]------[]------[]------[]------[]------[]------[]------[]------[]------[]------[]------[]------[]------[]------[]------[]------[]------[]------[]------[]------[]------[]------[]----------
XXXXXXXXXXXXXXXXXXXXXXXXXXXXXXXXXXXXXXXXXXXXXXXXXXXXXXXXXXXXXXXXXXXXXXXXXXXXXXXXXXXXXXXXXXXXXXXXXXXXXXXXXXXXXXXXXXXXXXXXXXXXXXXXXXXXXXXXXXXXXXXXXXXXXXXXXXXXXXXXXXXXXXXXXXXXXXXXXXXXXXXXXXXXXXXXXXXXXXXXXXXXXXXXXXXXXXXXXXXX
