XXXXXXXXXXXXXXXXXXXXXXXXXXXXXXXXXXXXXXXXXXXXXXXXXXXXXXXXXXXXXXXXXXXXXXXXXXXXXXXXXXXXXXXXXXXXXXXXXXXXXXXXXXXXXXXXXXXXXXXXXXXXXXXXXXXXXXXXXXXXXXXXXXXXXXXXXXXXXXXXXXXXXXXXXXXXXXXXXXXXXXXXXXXXXXXXXXXXXXXXXXXXXXXXXXXXXXXXXXXX
----------------[]------[]------[]------[]------[]------[]------[]------[]------[]------[]------[]------[]------[]------[]------[]------[]------[]------[]------[]------[]------[]------[]------[]------[]------[]----------
----------------[]------<>------[]------[]------[]------[]------<>------<>------[]------[]------<>------[]------[]------[]------[]------[]------[]------[]------[]------<>------<>------<>------<>------[]------[]----------
----------------[]--------------<>------[]------[]------<>----------------------<>------[]--------------<>------[]------[]------[]------[]------[]------<>------<>--------------------------------------<>------[]----------
----------------[]----------------------<>------<>--------------------------------------<>----------------------[]------<>------[]------[]------<>--------------------------------------------------------------[]----------
----------------[]----------------------------------------------------------------------------------------------<>--------------<>------[]--------------------------------------<>------<>------<>--------------<>----------
----------------<>------<>------<>----------------------<>------------------------------------------------------------------------------[]--------------------------------------[]------[]------[]--------------------------
------------------------[]------[]----------------------[]--------------<>----------------------------------------------<>--------------<>--------------<>--------------<>------[]------[]------[]------<>------------------
------------------------[]------[]------<>--------------[]--------------[]----------------------------------------------[]------------------------------[]--------------[]------[]------[]------[]------[]------<>----------
------------------------[]------[]------[]------<>------[]------<>------[]--------------<>------<>----------------------[]------------------------------[]------<>------[]------[]------[]------[]------[]------[]----------
------------------------[]------[]------[]------[]------[]------[]------[]--------------[]------[]----------------------[]------<>------<>--------------[]------[]------[]------[]------[]------[]------[]------[]----------
----------------<>------[]------[]------[]------[]------[]------[]------[]------<>------[]------[]------<>------<>------[]------[]------[]------<>------[]------[]------[]------[]------[]------[]------[]------[]----------
----------------[]------[]------[]------[]------[]------[]------[]------[]------[]------[]------[]------[]------[]------[]------[]------[]------[]------[]------[]------[]------[]------[]------[]------[]------[]----------
XXXXXXXXXXXXXXXXXXXXXXXXXXXXXXXXXXXXXXXXXXXXXXXXXXXXXXXXXXXXXXXXXXXXXXXXXXXXXXXXXXXXXXXXXXXXXXXXXXXXXXXXXXXXXXXXXXXXXXXXXXXXXXXXXXXXXXXXXXXXXXXXXXXXXXXXXXXXXXXXXXXXXXXXXXXXXXXXXXXXXXXXXXXXXXXXXXXXXXXXXXXXXXXXXXXXXXXXXXXX
