XXXXXXXXXXXXXXXXXXXXXXXXXXXXXXXXXXXXXXXXXXXXXXXXXXXXXXXXXXXXXXXXXXXXXXXXXXXXXXXXXXXXXXXXXXXXXXXXXXXXXXXXXXXXXXXXXXXXXXXXXXXXXXXXXXXXXXXXXXXXXXXXXXXXXXXXXXXXXXXXXXXXXXXXXXXXXXXXXXXXXXXXXXXXXXXXXXXXXXXXXXXXXXXXXXXXXXXXXXXX
----------------[]------[]------[]------[]------[]------[]------[]------[]------[]------[]------[]------[]------[]------[]------[]------[]------[]------[]------[]------[]------[]------[]------[]------[]------[]----------
----------------<>------<>------<>------<>------[]------[]------<>------<>------<>------[]------[]------[]------<>------[]------[]------[]------[]------[]------[]------<>------[]------<>------[]------[]------<>----------
------------------------------------------------<>------<>------------------------------[]------[]------[]--------------<>------[]------[]------[]------[]------[]--------------<>--------------[]------[]------------------
----------------------------------------------------------------------------------------[]------<>------<>----------------------<>------[]------[]------<>------[]------------------------------<>------[]------------------
----------------------------------------------------------------------------------------[]----------------------<>----------------------[]------<>--------------[]--------------------------------------<>------------------
--------------------------------------------------------<>------------------------------[]----------------------[]----------------------[]----------------------<>----------------------------------------------------------
----------------<>--------------<>----------------------[]------------------------------[]------<>--------------[]----------------------[]--------------<>--------------------------------------<>--------------<>----------
----------------[]--------------[]----------------------[]----------------------<>------<>------[]--------------[]------<>--------------<>--------------[]--------------<>------<>--------------[]--------------[]----------
----------------[]--------------[]----------------------[]--------------<>------[]--------------[]--------------[]------[]------<>--------------<>------[]------<>------[]------[]------<>------[]------<>------[]----------
----------------[]--------------[]--------------<>------[]------<>------[]------[]--------------[]------<>------[]------[]------[]--------------[]------[]------[]------[]------[]------[]------[]------[]------[]----------
----------------[]------<>------[]------<>------[]------[]------[]------[]------[]------<>------[]------[]------[]------[]------[]------<>------[]------[]------[]------[]------[]------[]------[]------[]------[]----------
----------------[]------[]------[]------[]------[]------[]------[]------[]------[]------[]------[]------[]------[]------[]------[]------[]------[]------[]------[]------[]------[]------[]------[]------[]------[]----------
XXXXXXXXXXXXXXXXXXXXXXXXXXXXXXXXXXXXXXXXXXXXXXXXXXXXXXXXXXXXXXXXXXXXXXXXXXXXXXXXXXXXXXXXXXXXXXXXXXXXXXXXXXXXXXXXXXXXXXXXXXXXXXXXXXXXXXXXXXXXXXXXXXXXXXXXXXXXXXXXXXXXXXXXXXXXXXXXXXXXXXXXXXXXXXXXXXXXXXXXXXXXXXXXXXXXXXXXXXXX
