XXXXXXXXXXXXXXXXXXXXXXXXXXXXXXXXXXXXXXXXXXXXXXXXXXXXXXXXXXXXXXXXXXXXXXXXXXXXXXXXXXXXXXXXXXXXXXXXXXXXXXXXXXXXXXXXXXXXXXXXXXXXXXXXXXXXXXXXXXXXXXXXXXXXXXXXXXXXXXXXXXXXXXXXXXXXXXXXXXXXXXXXXXXXXXXXXXXXXXXXXXXXXXXXXXXXXXXXXXXX
----------------[]------[]------[]------[]------[]------[]------[]------[]------[]------[]------[]------[]------[]------[]------[]------[]------[]------[]------[]------[]------[]------[]------[]------[]------[]----------
----------------<>------[]------[]------[]------[]------[]------[]------[]------[]------<>------[]------<>------<>------[]------[]------<>------<>------<>------<>------<>------<>------[]------[]------<>------[]----------
------------------------<>------<>------[]------<>------[]------<>------[]------<>--------------<>----------------------[]------[]------------------------------------------------------[]------[]--------------<>----------
----------------------------------------<>--------------<>--------------[]----------------------------------------------<>------[]------------------------------------------------------[]------<>--------------------------
------------------------------------------------------------------------[]------------------------------<>------<>--------------[]------------------------------<>------<>------<>------<>--------------<>------------------
------------------------<>--------------------------------------<>------<>----------------------<>------[]------[]--------------[]------------------------------[]------[]------[]----------------------[]------------------
----------------<>------[]--------------<>------<>--------------[]--------------<>--------------[]------[]------[]------<>------<>--------------<>------<>------[]------[]------[]----------------------[]------<>----------
----------------[]------[]--------------[]------[]--------------[]--------------[]--------------[]------[]------[]------[]----------------------[]------[]------[]------[]------[]--------------<>------[]------[]----------
----------------[]------[]------<>------[]------[]--------------[]--------------[]--------------[]------[]------[]------[]----------------------[]------[]------[]------[]------[]------<>------[]------[]------[]----------
----------------[]------[]------[]------[]------[]--------------[]------<>------[]--------------[]------[]------[]------[]------<>--------------[]------[]------[]------[]------[]------[]------[]------[]------[]----------
----------------[]------[]------[]------[]------[]------<>------[]------[]------[]------<>------[]------[]------[]------[]------[]------<>------[]------[]------[]------[]------[]------[]------[]------[]------[]----------
----------------[]------[]------[]------[]------[]------[]------[]------[]------[]------[]------[]------[]------[]------[]------[]------[]------[]------[]------[]------[]------[]------[]------[]------[]------[]----------
XXXXXXXXXXXXXXXXXXXXXXXXXXXXXXXXXXXXXXXXXXXXXXXXXXXXXXXXXXXXXXXXXXXXXXXXXXXXXXXXXXXXXXXXXXXXXXXXXXXXXXXXXXXXXXXXXXXXXXXXXXXXXXXXXXXXXXXXXXXXXXXXXXXXXXXXXXXXXXXXXXXXXXXXXXXXXXXXXXXXXXXXXXXXXXXXXXXXXXXXXXXXXXXXXXXXXXXXXXXX
