XXXXXXXXXXXXXXXXXXXXXXXXXXXXXXXXXXXXXXXXXXXXXXXXXXXXXXXXXXXXXXXXXXXXXXXXXXXXXXXXXXXXXXXXXXXXXXXXXXXXXXXXXXXXXXXXXXXXXXXXXXXXXXXXXXXXXXXXXXXXXXXXXXXXXXXXXXXXXXXXXXXXXXXXXXXXXXXXXXXXXXXXXXXXXXXXXXXXXXXXXXXXXXXXXXXXXXXXXXXX
----------------[]------[]------[]------[]------[]------[]------[]------[]------[]------[]------[]------[]------[]------[]------[]------[]------[]------[]------[]------[]------[]------[]------[]------[]------[]----------
----------------<>------[]------<>------[]------[]------[]------[]------<>------[]------<>------<>------[]------<>------[]------[]------[]------[]------[]------<>------[]------<>------[]------<>------[]------<>----------
------------------------[]--------------[]------<>------<>------[]--------------[]----------------------[]--------------<>------[]------[]------[]------[]--------------[]--------------[]--------------[]------------------
------------------------[]--------------[]----------------------[]--------------[]----------------------[]----------------------<>------[]------[]------<>--------------<>--------------<>--------------<>------------------
----------------<>------[]------<>------<>----------------------[]--------------[]------<>------<>------[]------------------------------[]------<>--------------<>--------------<>------------------------------------------
----------------[]------[]------[]--------------<>--------------[]--------------[]------[]------[]------[]------<>------<>--------------<>----------------------[]--------------[]------------------------------<>----------
----------------[]------<>------[]--------------[]--------------<>--------------<>------[]------[]------[]------[]------[]--------------------------------------[]--------------[]----------------------<>------[]----------
----------------[]--------------[]--------------[]--------------------------------------[]------[]------<>------[]------[]------<>------------------------------[]--------------[]----------------------[]------[]----------
----------------[]--------------[]--------------[]------<>--------------<>--------------[]------[]--------------[]------[]------[]------<>--------------<>------[]--------------[]------<>------<>------[]------[]----------
----------------[]------<>------[]--------------[]------[]--------------[]------<>------[]------[]--------------[]------[]------[]------[]--------------[]------[]--------------[]------[]------[]------[]------[]----------
----------------[]------[]------[]------<>------[]------[]------<>------[]------[]------[]------[]------<>------[]------[]------[]------[]------<>------[]------[]------<>------[]------[]------[]------[]------[]----------
----------------[]------[]------[]------[]------[]------[]------[]------[]------[]------[]------[]------[]------[]------[]------[]------[]------[]------[]------[]------[]------[]------[]------[]------[]------[]----------
XXXXXXXXXXXXXXXXXXXXXXXXXXXXXXXXXXXXXXXXXXXXXXXXXXXXXXXXXXXXXXXXXXXXXXXXXXXXXXXXXXXXXXXXXXXXXXXXXXXXXXXXXXXXXXXXXXXXXXXXXXXXXXXXXXXXXXXXXXXXXXXXXXXXXXXXXXXXXXXXXXXXXXXXXXXXXXXXXXXXXXXXXXXXXXXXXXXXXXXXXXXXXXXXXXXXXXXXXXXX
