XXXXXXXXXXXXXXXXXXXXXXXXXXXXXXXXXXXXXXXXXXXXXXXXXXXXXXXXXXXXXXXXXXXXXXXXXXXXXXXXXXXXXXXXXXXXXXXXXXXXXXXXXXXXXXXXXXXXXXXXXXXXXXXXXXXXXXXXXXXXXXXXXXXXXXXXXXXXXXXXXXXXXXXXXXXXXXXXXXXXXXXXXXXXXXXXXXXXXXXXXXXXXXXXXXXXXXXXXXXX
----------------[]------[]------[]------[]------[]------[]------[]------[]------[]------[]------[]------[]------[]------[]------[]------[]------[]------[]------[]------[]------[]------[]------[]------[]------[]----------
----------------<>------<>------<>------[]------<>------[]------<>------<>------[]------[]------<>------[]------[]------[]------<>------[]------[]------[]------[]------[]------[]------[]------[]------[]------[]----------
----------------------------------------<>--------------[]----------------------<>------[]--------------[]------[]------[]--------------<>------<>------<>------[]------[]------<>------[]------<>------<>------<>----------
--------------------------------------------------------<>------------------------------[]--------------[]------<>------[]--------------------------------------[]------<>--------------[]----------------------------------
----------------<>------<>--------------------------------------<>------<>--------------[]--------------[]--------------<>--------------------------------------<>----------------------[]----------------------------------
----------------[]------[]------<>------<>------<>--------------[]------[]--------------<>--------------<>------------------------------------------------------------------------------[]----------------------------------
----------------[]------[]------[]------[]------[]--------------[]------[]--------------------------------------------------------------<>------<>------------------------------<>------<>--------------<>------------------
----------------[]------[]------[]------[]------[]--------------[]------[]--------------------------------------<>------<>------<>------[]------[]------<>--------------<>------[]----------------------[]------<>----------
----------------[]------[]------[]------[]------[]------<>------[]------[]--------------<>------<>------<>------[]------[]------[]------[]------[]------[]------<>------[]------[]--------------<>------[]------[]----------
----------------[]------[]------[]------[]------[]------[]------[]------[]--------------[]------[]------[]------[]------[]------[]------[]------[]------[]------[]------[]------[]--------------[]------[]------[]----------
----------------[]------[]------[]------[]------[]------[]------[]------[]------<>------[]------[]------[]------[]------[]------[]------[]------[]------[]------[]------[]------[]------<>------[]------[]------[]----------
----------------[]------[]------[]------[]------[]------[]------[]------[]------[]------[]------[]------[]------[]------[]------[]------[]------[]------[]------[]------[]------[]------[]------[]------[]------[]----------
XXXXXXXXXXXXXXXXXXXXXXXXXXXXXXXXXXXXXXXXXXXXXXXXXXXXXXXXXXXXXXXXXXXXXXXXXXXXXXXXXXXXXXXXXXXXXXXXXXXXXXXXXXXXXXXXXXXXXXXXXXXXXXXXXXXXXXXXXXXXXXXXXXXXXXXXXXXXXXXXXXXXXXXXXXXXXXXXXXXXXXXXXXXXXXXXXXXXXXXXXXXXXXXXXXXXXXXXXXXX
