XXXXXXXXXXXXXXXXXXXXXXXXXXXXXXXXXXXXXXXXXXXXXXXXXXXXXXXXXXXXXXXXXXXXXXXXXXXXXXXXXXXXXXXXXXXXXXXXXXXXXXXXXXXXXXXXXXXXXXXXXXXXXXXXXXXXXXXXXXXXXXXXXXXXXXXXXXXXXXXXXXXXXXXXXXXXXXXXXXXXXXXXXXXXXXXXXXXXXXXXXXXXXXXXXXXXXXXXXXXX
----------------[]------[]------[]------[]------[]------[]------[]------[]------[]------[]------[]------[]------[]------[]------[]------[]------[]------[]------[]------[]------[]------[]------[]------[]------[]----------
----------------<>------[]------[]------[]------[]------<>------[]------[]------[]------<>------<>------[]------[]------[]------[]------<>------<>------[]------<>------[]------<>------<>------[]------[]------[]----------
------------------------[]------[]------<>------[]--------------<>------<>------[]----------------------<>------[]------<>------[]----------------------[]--------------[]----------------------[]------[]------<>----------
------------------------<>------[]--------------[]------------------------------[]------------------------------[]--------------<>----------------------[]--------------<>----------------------[]------<>------------------
--------------------------------[]--------------[]------<>----------------------[]------------------------------[]----------------------<>--------------<>--------------------------------------[]--------------------------
----------------<>--------------<>------<>------[]------[]--------------<>------<>------<>------<>--------------<>----------------------[]------------------------------------------------------[]--------------<>----------
----------------[]------<>--------------[]------<>------[]--------------[]--------------[]------[]--------------------------------------[]------<>----------------------------------------------[]------<>------[]----------
----------------[]------[]--------------[]--------------[]--------------[]--------------[]------[]------<>------------------------------[]------[]----------------------------------------------<>------[]------[]----------
----------------[]------[]------<>------[]--------------[]--------------[]------<>------[]------[]------[]----------------------<>------[]------[]------------------------------------------------------[]------[]----------
----------------[]------[]------[]------[]------<>------[]--------------[]------[]------[]------[]------[]------<>------<>------[]------[]------[]------<>------<>--------------<>------<>--------------[]------[]----------
----------------[]------[]------[]------[]------[]------[]------<>------[]------[]------[]------[]------[]------[]------[]------[]------[]------[]------[]------[]------<>------[]------[]------<>------[]------[]----------
----------------[]------[]------[]------[]------[]------[]------[]------[]------[]------[]------[]------[]------[]------[]------[]------[]------[]------[]------[]------[]------[]------[]------[]------[]------[]----------
XXXXXXXXXXXXXXXXXXXXXXXXXXXXXXXXXXXXXXXXXXXXXXXXXXXXXXXXXXXXXXXXXXXXXXXXXXXXXXXXXXXXXXXXXXXXXXXXXXXXXXXXXXXXXXXXXXXXXXXXXXXXXXXXXXXXXXXXXXXXXXXXXXXXXXXXXXXXXXXXXXXXXXXXXXXXXXXXXXXXXXXXXXXXXXXXXXXXXXXXXXXXXXXXXXXXXXXXXXXX
