XXXXXXXXXXXXXXXXXXXXXXXXXXXXXXXXXXXXXXXXXXXXXXXXXXXXXXXXXXXXXXXXXXXXXXXXXXXXXXXXXXXXXXXXXXXXXXXXXXXXXXXXXXXXXXXXXXXXXXXXXXXXXXXXXXXXXXXXXXXXXXXXXXXXXXXXXXXXXXXXXXXXXXXXXXXXXXXXXXXXXXXXXXXXXXXXXXXXXXXXXXXXXXXXXXXXXXXXXXXX
----------------[]------[]------[]------[]------[]------[]------[]------[]------[]------[]------[]------[]------[]------[]------[]------[]------[]------[]------[]------[]------[]------[]------[]------[]------[]----------
----------------[]------<>------[]------[]------<>------[]------<>------<>------[]------<>------<>------[]------<>------[]------<>------<>------<>------[]------<>------<>------[]------[]------<>------<>------[]----------
----------------[]--------------[]------<>--------------<>----------------------<>----------------------<>--------------<>------------------------------[]----------------------[]------<>----------------------[]----------
----------------<>--------------[]----------------------------------------------------------------------------------------------------------------------<>----------------------[]------------------------------[]----------
--------------------------------[]------------------------------<>------------------------------<>--------------------------------------<>--------------------------------------<>----------------------<>------[]----------
--------------------------------<>------<>------<>--------------[]--------------<>------<>------[]------<>--------------<>--------------[]----------------------<>--------------------------------------[]------<>----------
----------------<>----------------------[]------[]------<>------[]--------------[]------[]------[]------[]--------------[]------<>------[]------<>--------------[]--------------------------------------[]------------------
----------------[]----------------------[]------[]------[]------[]------<>------[]------[]------[]------[]--------------[]------[]------[]------[]------<>------[]------------------------------<>------[]------------------
----------------[]------<>------<>------[]------[]------[]------[]------[]------[]------[]------[]------[]------<>------[]------[]------[]------[]------[]------[]------------------------------[]------[]------<>----------
----------------[]------[]------[]------[]------[]------[]------[]------[]------[]------[]------[]------[]------[]------[]------[]------[]------[]------[]------[]----------------------<>------[]------[]------[]----------
----------------[]------[]------[]------[]------[]------[]------[]------[]------[]------[]------[]------[]------[]------[]------[]------[]------[]------[]------[]------<>------<>------[]------[]------[]------[]----------
----------------[]------[]------[]------[]------[]------[]------[]------[]------[]------[]------[]------[]------[]------[]------[]------[]------[]------[]------[]------[]------[]------[]------[]------[]------[]----------
XXXXXXXXXXXXXXXXXXXXXXXXXXXXXXXXXXXXXXXXXXXXXXXXXXXXXXXXXXXXXXXXXXXXXXXXXXXXXXXXXXXXXXXXXXXXXXXXXXXXXXXXXXXXXXXXXXXXXXXXXXXXXXXXXXXXXXXXXXXXXXXXXXXXXXXXXXXXXXXXXXXXXXXXXXXXXXXXXXXXXXXXXXXXXXXXXXXXXXXXXXXXXXXXXXXXXXXXXXXX
