XXXXXXXXXXXXXXXXXXXXXXXXXXXXXXXXXXXXXXXXXXXXXXXXXXXXXXXXXXXXXXXXXXXXXXXXXXXXXXXXXXXXXXXXXXXXXXXXXXXXXXXXXXXXXXXXXXXXXXXXXXXXXXXXXXXXXXXXXXXXXXXXXXXXXXXXXXXXXXXXXXXXXXXXXXXXXXXXXXXXXXXXXXXXXXXXXXXXXXXXXXXXXXXXXXXXXXXXXXXX
----------------[]------[]------[]------[]------[]------[]------[]------[]------[]------[]------[]------[]------[]------[]------[]------[]------[]------[]------[]------[]------[]------[]------[]------[]------[]----------
----------------[]------<>------<>------<>------[]------[]------[]------[]------[]------<>------[]------[]------[]------[]------<>------[]------[]------[]------[]------[]------[]------[]------[]------[]------[]----------
----------------[]------------------------------<>------<>------[]------[]------[]--------------[]------<>------[]------<>--------------<>------[]------[]------[]------[]------<>------<>------<>------<>------[]----------
----------------[]----------------------------------------------[]------[]------<>--------------[]--------------[]------------------------------<>------[]------[]------[]--------------------------------------[]----------
----------------<>----------------------<>----------------------[]------<>--------------<>------[]--------------<>--------------<>----------------------[]------[]------<>--------------------------------------<>----------
----------------------------------------[]----------------------[]----------------------[]------<>----------------------<>------[]------<>--------------<>------<>--------------------------------------<>------------------
----------------------------------------[]----------------------<>----------------------[]------------------------------[]------[]------[]------------------------------------------------------<>------[]------------------
------------------------<>--------------[]------<>------<>----------------------<>------[]--------------<>------<>------[]------[]------[]------<>----------------------------------------------[]------[]------<>----------
------------------------[]------<>------[]------[]------[]----------------------[]------[]--------------[]------[]------[]------[]------[]------[]------<>------<>--------------<>------<>------[]------[]------[]----------
----------------<>------[]------[]------[]------[]------[]--------------<>------[]------[]------<>------[]------[]------[]------[]------[]------[]------[]------[]------<>------[]------[]------[]------[]------[]----------
----------------[]------[]------[]------[]------[]------[]------<>------[]------[]------[]------[]------[]------[]------[]------[]------[]------[]------[]------[]------[]------[]------[]------[]------[]------[]----------
----------------[]------[]------[]------[]------[]------[]------[]------[]------[]------[]------[]------[]------[]------[]------[]------[]------[]------[]------[]------[]------[]------[]------[]------[]------[]----------
XXXXXXXXXXXXXXXXXXXXXXXXXXXXXXXXXXXXXXXXXXXXXXXXXXXXXXXXXXXXXXXXXXXXXXXXXXXXXXXXXXXXXXXXXXXXXXXXXXXXXXXXXXXXXXXXXXXXXXXXXXXXXXXXXXXXXXXXXXXXXXXXXXXXXXXXXXXXXXXXXXXXXXXXXXXXXXXXXXXXXXXXXXXXXXXXXXXXXXXXXXXXXXXXXXXXXXXXXXXX
