XXXXXXXXXXXXXXXXXXXXXXXXXXXXXXXXXXXXXXXXXXXXXXXXXXXXXXXXXXXXXXXXXXXXXXXXXXXXXXXXXXXXXXXXXXXXXXXXXXXXXXXXXXXXXXXXXXXXXXXXXXXXXXXXXXXXXXXXXXXXXXXXXXXXXXXXXXXXXXXXXXXXXXXXXXXXXXXXXXXXXXXXXXXXXXXXXXXXXXXXXXXXXXXXXXXXXXXXXXXX
----------------[]------[]------[]------[]------[]------[]------[]------[]------[]------[]------[]------[]------[]------[]------[]------[]------[]------[]------[]------[]------[]------[]------[]------[]------[]----------
----------------<>------<>------[]------<>------[]------[]------<>------<>------[]------[]------[]------[]------<>------[]------<>------<>------<>------<>------[]------<>------<>------<>------<>------<>------[]----------
--------------------------------<>--------------[]------<>----------------------[]------<>------[]------[]--------------<>--------------------------------------[]----------------------------------------------<>----------
------------------------------------------------<>------------------------------[]--------------[]------[]------------------------------------------------------[]----------------------------------------------------------
----------------------------------------------------------------<>------<>------[]--------------<>------<>----------------------<>------<>------<>--------------<>----------------------<>------<>--------------------------
----------------<>----------------------<>----------------------[]------[]------<>------<>----------------------<>------<>------[]------[]------[]------<>------------------------------[]------[]------<>------------------
----------------[]----------------------[]------<>--------------[]------[]--------------[]----------------------[]------[]------[]------[]------[]------[]--------------<>--------------[]------[]------[]------------------
----------------[]--------------<>------[]------[]------<>------[]------[]--------------[]----------------------[]------[]------[]------[]------[]------[]--------------[]--------------[]------[]------[]------------------
----------------[]--------------[]------[]------[]------[]------[]------[]--------------[]--------------<>------[]------[]------[]------[]------[]------[]--------------[]------<>------[]------[]------[]------------------
----------------[]--------------[]------[]------[]------[]------[]------[]------<>------[]------<>------[]------[]------[]------[]------[]------[]------[]--------------[]------[]------[]------[]------[]------------------
----------------[]------<>------[]------[]------[]------[]------[]------[]------[]------[]------[]------[]------[]------[]------[]------[]------[]------[]------<>------[]------[]------[]------[]------[]------<>----------
----------------[]------[]------[]------[]------[]------[]------[]------[]------[]------[]------[]------[]------[]------[]------[]------[]------[]------[]------[]------[]------[]------[]------[]------[]------[]----------
XXXXXXXXXXXXXXXXXXXXXXXXXXXXXXXXXXXXXXXXXXXXXXXXXXXXXXXXXXXXXXXXXXXXXXXXXXXXXXXXXXXXXXXXXXXXXXXXXXXXXXXXXXXXXXXXXXXXXXXXXXXXXXXXXXXXXXXXXXXXXXXXXXXXXXXXXXXXXXXXXXXXXXXXXXXXXXXXXXXXXXXXXXXXXXXXXXXXXXXXXXXXXXXXXXXXXXXXXXXX
