XXXXXXXXXXXXXXXXXXXXXXXXXXXXXXXXXXXXXXXXXXXXXXXXXXXXXXXXXXXXXXXXXXXXXXXXXXXXXXXXXXXXXXXXXXXXXXXXXXXXXXXXXXXXXXXXXXXXXXXXXXXXXXXXXXXXXXXXXXXXXXXXXXXXXXXXXXXXXXXXXXXXXXXXXXXXXXXXXXXXXXXXXXXXXXXXXXXXXXXXXXXXXXXXXXXXXXXXXXXX
----------------[]------[]------[]------[]------[]------[]------[]------[]------[]------[]------[]------[]------[]------[]------[]------[]------[]------[]------[]------[]------[]------[]------[]------[]------[]----------
----------------<>------<>------<>------[]------[]------[]------<>------[]------<>------[]------<>------<>------[]------<>------[]------[]------[]------[]------[]------<>------[]------<>------[]------[]------<>----------
----------------------------------------<>------[]------[]--------------[]--------------[]----------------------[]--------------[]------[]------[]------[]------<>--------------[]--------------[]------<>------------------
------------------------------------------------<>------<>--------------[]--------------[]----------------------[]--------------[]------[]------<>------<>----------------------[]--------------[]--------------------------
----------------<>------------------------------------------------------<>------<>------[]------<>--------------[]--------------[]------<>------------------------------<>------[]--------------[]--------------<>----------
----------------[]----------------------<>--------------------------------------[]------<>------[]--------------[]--------------<>--------------------------------------[]------<>--------------[]------<>------[]----------
----------------[]----------------------[]--------------<>----------------------[]--------------[]--------------[]------------------------------------------------------[]--------------<>------[]------[]------[]----------
----------------[]----------------------[]--------------[]------<>--------------[]--------------[]------<>------<>------------------------------<>------<>--------------[]--------------[]------<>------[]------[]----------
----------------[]--------------<>------[]------<>------[]------[]--------------[]--------------[]------[]------------------------------<>------[]------[]------<>------[]------<>------[]--------------[]------[]----------
----------------[]--------------[]------[]------[]------[]------[]--------------[]--------------[]------[]--------------<>------<>------[]------[]------[]------[]------[]------[]------[]--------------[]------[]----------
----------------[]------<>------[]------[]------[]------[]------[]------<>------[]------<>------[]------[]------<>------[]------[]------[]------[]------[]------[]------[]------[]------[]------<>------[]------[]----------
----------------[]------[]------[]------[]------[]------[]------[]------[]------[]------[]------[]------[]------[]------[]------[]------[]------[]------[]------[]------[]------[]------[]------[]------[]------[]----------
XXXXXXXXXXXXXXXXXXXXXXXXXXXXXXXXXXXXXXXXXXXXXXXXXXXXXXXXXXXXXXXXXXXXXXXXXXXXXXXXXXXXXXXXXXXXXXXXXXXXXXXXXXXXXXXXXXXXXXXXXXXXXXXXXXXXXXXXXXXXXXXXXXXXXXXXXXXXXXXXXXXXXXXXXXXXXXXXXXXXXXXXXXXXXXXXXXXXXXXXXXXXXXXXXXXXXXXXXXXX
