XXXXXXXXXXXXXXXXXXXXXXXXXXXXXXXXXXXXXXXXXXXXXXXXXXXXXXXXXXXXXXXXXXXXXXXXXXXXXXXXXXXXXXXXXXXXXXXXXXXXXXXXXXXXXXXXXXXXXXXXXXXXXXXXXXXXXXXXXXXXXXXXXXXXXXXXXXXXXXXXXXXXXXXXXXXXXXXXXXXXXXXXXXXXXXXXXXXXXXXXXXXXXXXXXXXXXXXXXXXX
----------------[]------[]------[]------[]------[]------[]------[]------[]------[]------[]------[]------[]------[]------[]------[]------[]------[]------[]------[]------[]------[]------[]------[]------[]------[]----------
----------------<>------<>------<>------[]------<>------<>------<>------[]------[]------[]------[]------[]------<>------<>------<>------<>------[]------<>------[]------[]------[]------<>------[]------[]------<>----------
----------------------------------------<>------------------------------<>------[]------<>------<>------[]--------------------------------------<>--------------[]------[]------[]--------------[]------[]------------------
--------------------------------------------------------------------------------[]----------------------[]------------------------------------------------------<>------[]------[]--------------<>------[]------------------
----------------<>--------------------------------------------------------------<>----------------------<>------<>----------------------<>------------------------------[]------[]------<>--------------<>------<>----------
----------------[]----------------------------------------------------------------------<>----------------------[]------<>--------------[]------------------------------[]------[]------[]----------------------[]----------
----------------[]------------------------------<>------<>------<>----------------------[]----------------------[]------[]--------------[]----------------------<>------<>------<>------[]----------------------[]----------
----------------[]--------------<>--------------[]------[]------[]--------------<>------[]----------------------[]------[]--------------[]------<>--------------[]----------------------[]------<>------<>------[]----------
----------------[]--------------[]--------------[]------[]------[]------<>------[]------[]----------------------[]------[]--------------[]------[]------<>------[]----------------------[]------[]------[]------[]----------
----------------[]------<>------[]------<>------[]------[]------[]------[]------[]------[]--------------<>------[]------[]--------------[]------[]------[]------[]------<>------<>------[]------[]------[]------[]----------
----------------[]------[]------[]------[]------[]------[]------[]------[]------[]------[]------<>------[]------[]------[]------<>------[]------[]------[]------[]------[]------[]------[]------[]------[]------[]----------
----------------[]------[]------[]------[]------[]------[]------[]------[]------[]------[]------[]------[]------[]------[]------[]------[]------[]------[]------[]------[]------[]------[]------[]------[]------[]----------
XXXXXXXXXXXXXXXXXXXXXXXXXXXXXXXXXXXXXXXXXXXXXXXXXXXXXXXXXXXXXXXXXXXXXXXXXXXXXXXXXXXXXXXXXXXXXXXXXXXXXXXXXXXXXXXXXXXXXXXXXXXXXXXXXXXXXXXXXXXXXXXXXXXXXXXXXXXXXXXXXXXXXXXXXXXXXXXXXXXXXXXXXXXXXXXXXXXXXXXXXXXXXXXXXXXXXXXXXXXX
