XXXXXXXXXXXXXXXXXXXXXXXXXXXXXXXXXXXXXXXXXXXXXXXXXXXXXXXXXXXXXXXXXXXXXXXXXXXXXXXXXXXXXXXXXXXXXXXXXXXXXXXXXXXXXXXXXXXXXXXXXXXXXXXXXXXXXXXXXXXXXXXXXXXXXXXXXXXXXXXXXXXXXXXXXXXXXXXXXXXXXXXXXXXXXXXXXXXXXXXXXXXXXXXXXXXXXXXXXXXX
----------------[]------[]------[]------[]------[]------[]------[]------[]------[]------[]------[]------[]------[]------[]------[]------[]------[]------[]------[]------[]------[]------[]------[]------[]------[]----------
----------------[]------[]------<>------[]------[]------<>------[]------[]------[]------<>------<>------[]------[]------<>------<>------[]------<>------[]------[]------<>------<>------[]------<>------[]------[]----------
----------------<>------[]--------------<>------[]--------------<>------<>------<>----------------------[]------[]----------------------<>--------------<>------[]----------------------[]--------------<>------[]----------
------------------------[]----------------------[]------------------------------------------------------[]------[]----------------------------------------------[]----------------------<>----------------------<>----------
------------------------[]------<>--------------<>------<>------------------------------<>------<>------<>------[]--------------<>--------------<>--------------[]------<>----------------------<>--------------------------
----------------<>------<>------[]----------------------[]------------------------------[]------[]--------------[]--------------[]--------------[]--------------[]------[]----------------------[]------<>------------------
----------------[]--------------[]----------------------[]------<>------<>--------------[]------[]--------------<>------<>------[]--------------[]--------------[]------[]----------------------[]------[]------------------
----------------[]--------------[]--------------<>------[]------[]------[]--------------[]------[]----------------------[]------[]------<>------[]--------------<>------[]--------------<>------[]------[]------<>----------
----------------[]--------------[]--------------[]------[]------[]------[]--------------[]------[]------<>--------------[]------[]------[]------[]------<>--------------[]--------------[]------[]------[]------[]----------
----------------[]--------------[]------<>------[]------[]------[]------[]------<>------[]------[]------[]------<>------[]------[]------[]------[]------[]--------------[]------<>------[]------[]------[]------[]----------
----------------[]------<>------[]------[]------[]------[]------[]------[]------[]------[]------[]------[]------[]------[]------[]------[]------[]------[]------<>------[]------[]------[]------[]------[]------[]----------
----------------[]------[]------[]------[]------[]------[]------[]------[]------[]------[]------[]------[]------[]------[]------[]------[]------[]------[]------[]------[]------[]------[]------[]------[]------[]----------
XXXXXXXXXXXXXXXXXXXXXXXXXXXXXXXXXXXXXXXXXXXXXXXXXXXXXXXXXXXXXXXXXXXXXXXXXXXXXXXXXXXXXXXXXXXXXXXXXXXXXXXXXXXXXXXXXXXXXXXXXXXXXXXXXXXXXXXXXXXXXXXXXXXXXXXXXXXXXXXXXXXXXXXXXXXXXXXXXXXXXXXXXXXXXXXXXXXXXXXXXXXXXXXXXXXXXXXXXXXX
