XXXXXXXXXXXXXXXXXXXXXXXXXXXXXXXXXXXXXXXXXXXXXXXXXXXXXXXXXXXXXXXXXXXXXXXXXXXXXXXXXXXXXXXXXXXXXXXXXXXXXXXXXXXXXXXXXXXXXXXXXXXXXXXXXXXXXXXXXXXXXXXXXXXXXXXXXXXXXXXXXXXXXXXXXXXXXXXXXXXXXXXXXXXXXXXXXXXXXXXXXXXXXXXXXXXXXXXXXXXX
----------------[]------[]------[]------[]------[]------[]------[]------[]------[]------[]------[]------[]------[]------[]------[]------[]------[]------[]------[]------[]------[]------[]------[]------[]------[]----------
----------------[]------<>------[]------[]------<>------<>------[]------[]------<>------<>------[]------[]------<>------<>------[]------[]------[]------[]------<>------[]------[]------[]------[]------[]------[]----------
----------------<>--------------<>------<>----------------------<>------[]----------------------[]------[]----------------------[]------[]------[]------[]--------------[]------[]------[]------[]------[]------[]----------
------------------------------------------------------------------------[]----------------------[]------[]----------------------[]------[]------[]------<>--------------[]------<>------<>------<>------<>------<>----------
------------------------------------------------------------------------[]--------------<>------[]------<>--------------<>------[]------[]------[]--------------<>------[]--------------------------------------------------
----------------------------------------<>--------------<>--------------<>------<>------[]------[]----------------------[]------[]------<>------<>--------------[]------<>--------------------------------------------------
----------------<>--------------<>------[]------<>------[]----------------------[]------[]------<>--------------<>------[]------<>------------------------------[]----------------------------------------------------------
----------------[]--------------[]------[]------[]------[]----------------------[]------[]----------------------[]------[]------------------------------<>------[]----------------------<>--------------<>------------------
----------------[]--------------[]------[]------[]------[]------<>--------------[]------[]----------------------[]------[]------------------------------[]------[]------<>--------------[]--------------[]------<>----------
----------------[]------<>------[]------[]------[]------[]------[]------<>------[]------[]----------------------[]------[]------<>------<>------<>------[]------[]------[]------<>------[]------<>------[]------[]----------
----------------[]------[]------[]------[]------[]------[]------[]------[]------[]------[]------<>------<>------[]------[]------[]------[]------[]------[]------[]------[]------[]------[]------[]------[]------[]----------
----------------[]------[]------[]------[]------[]------[]------[]------[]------[]------[]------[]------[]------[]------[]------[]------[]------[]------[]------[]------[]------[]------[]------[]------[]------[]----------
XXXXXXXXXXXXXXXXXXXXXXXXXXXXXXXXXXXXXXXXXXXXXXXXXXXXXXXXXXXXXXXXXXXXXXXXXXXXXXXXXXXXXXXXXXXXXXXXXXXXXXXXXXXXXXXXXXXXXXXXXXXXXXXXXXXXXXXXXXXXXXXXXXXXXXXXXXXXXXXXXXXXXXXXXXXXXXXXXXXXXXXXXXXXXXXXXXXXXXXXXXXXXXXXXXXXXXXXXXXX
