XXXXXXXXXXXXXXXXXXXXXXXXXXXXXXXXXXXXXXXXXXXXXXXXXXXXXXXXXXXXXXXXXXXXXXXXXXXXXXXXXXXXXXXXXXXXXXXXXXXXXXXXXXXXXXXXXXXXXXXXXXXXXXXXXXXXXXXXXXXXXXXXXXXXXXXXXXXXXXXXXXXXXXXXXXXXXXXXXXXXXXXXXXXXXXXXXXXXXXXXXXXXXXXXXXXXXXXXXXXX
----------------[]------[]------[]------[]------[]------[]------[]------[]------[]------[]------[]------[]------[]------[]------[]------[]------[]------[]------[]------[]------[]------[]------[]------[]------[]----------
----------------[]------[]------[]------[]------[]------<>------<>------[]------[]------<>------<>------[]------[]------<>------[]------[]------<>------[]------[]------[]------<>------<>------<>------[]------<>----------
----------------[]------[]------[]------[]------<>----------------------[]------[]----------------------<>------[]--------------<>------[]--------------[]------[]------<>------------------------------<>------------------
----------------<>------[]------[]------<>------------------------------<>------<>------------------------------[]----------------------[]--------------[]------[]----------------------------------------------------------
------------------------<>------[]----------------------<>------------------------------<>----------------------[]----------------------[]------<>------[]------<>--------------<>------------------------------------------
--------------------------------[]----------------------[]------------------------------[]------<>------<>------<>--------------<>------<>------[]------[]----------------------[]------------------------------<>----------
--------------------------------[]----------------------[]--------------<>------<>------[]------[]------[]----------------------[]--------------[]------<>--------------<>------[]------<>--------------<>------[]----------
--------------------------------<>----------------------[]------<>------[]------[]------[]------[]------[]----------------------[]--------------[]----------------------[]------[]------[]--------------[]------[]----------
------------------------------------------------<>------[]------[]------[]------[]------[]------[]------[]----------------------[]------<>------[]----------------------[]------[]------[]------<>------[]------[]----------
------------------------<>--------------<>------[]------[]------[]------[]------[]------[]------[]------[]------<>------<>------[]------[]------[]------<>--------------[]------[]------[]------[]------[]------[]----------
----------------<>------[]------<>------[]------[]------[]------[]------[]------[]------[]------[]------[]------[]------[]------[]------[]------[]------[]------<>------[]------[]------[]------[]------[]------[]----------
----------------[]------[]------[]------[]------[]------[]------[]------[]------[]------[]------[]------[]------[]------[]------[]------[]------[]------[]------[]------[]------[]------[]------[]------[]------[]----------
XXXXXXXXXXXXXXXXXXXXXXXXXXXXXXXXXXXXXXXXXXXXXXXXXXXXXXXXXXXXXXXXXXXXXXXXXXXXXXXXXXXXXXXXXXXXXXXXXXXXXXXXXXXXXXXXXXXXXXXXXXXXXXXXXXXXXXXXXXXXXXXXXXXXXXXXXXXXXXXXXXXXXXXXXXXXXXXXXXXXXXXXXXXXXXXXXXXXXXXXXXXXXXXXXXXXXXXXXXXX
