XXXXXXXXXXXXXXXXXXXXXXXXXXXXXXXXXXXXXXXXXXXXXXXXXXXXXXXXXXXXXXXXXXXXXXXXXXXXXXXXXXXXXXXXXXXXXXXXXXXXXXXXXXXXXXXXXXXXXXXXXXXXXXXXXXXXXXXXXXXXXXXXXXXXXXXXXXXXXXXXXXXXXXXXXXXXXXXXXXXXXXXXXXXXXXXXXXXXXXXXXXXXXXXXXXXXXXXXXXXX
----------------[]------[]------[]------[]------[]------[]------[]------[]------[]------[]------[]------[]------[]------[]------[]------[]------[]------[]------[]------[]------[]------[]------[]------[]------[]----------
----------------<>------[]------[]------[]------<>------[]------[]------<>------[]------[]------<>------<>------[]------[]------<>------[]------<>------[]------[]------[]------[]------<>------[]------[]------<>----------
------------------------<>------[]------[]--------------<>------[]--------------[]------[]----------------------[]------[]--------------[]--------------[]------[]------<>------[]--------------<>------<>------------------
--------------------------------<>------[]----------------------[]--------------<>------<>----------------------<>------[]--------------<>--------------[]------[]--------------<>------------------------------------------
----------------<>----------------------[]------<>--------------<>------<>------------------------------<>--------------<>------------------------------[]------[]----------------------<>----------------------------------
----------------[]----------------------[]------[]------<>--------------[]------------------------------[]----------------------------------------------[]------<>------<>--------------[]------<>------<>------------------
----------------[]----------------------[]------[]------[]--------------[]------------------------------[]----------------------------------------------<>--------------[]--------------[]------[]------[]------------------
----------------[]----------------------<>------[]------[]--------------[]------------------------------[]--------------<>------<>--------------------------------------[]------<>------[]------[]------[]------------------
----------------[]------------------------------[]------[]--------------[]------------------------------[]------<>------[]------[]--------------------------------------[]------[]------[]------[]------[]------<>----------
----------------[]------<>------<>--------------[]------[]--------------[]------<>------<>--------------[]------[]------[]------[]------<>--------------<>------<>------[]------[]------[]------[]------[]------[]----------
----------------[]------[]------[]------<>------[]------[]------<>------[]------[]------[]------<>------[]------[]------[]------[]------[]------<>------[]------[]------[]------[]------[]------[]------[]------[]----------
----------------[]------[]------[]------[]------[]------[]------[]------[]------[]------[]------[]------[]------[]------[]------[]------[]------[]------[]------[]------[]------[]------[]------[]------[]------[]----------
XXXXXXXXXXXXXXXXXXXXXXXXXXXXXXXXXXXXXXXXXXXXXXXXXXXXXXXXXXXXXXXXXXXXXXXXXXXXXXXXXXXXXXXXXXXXXXXXXXXXXXXXXXXXXXXXXXXXXXXXXXXXXXXXXXXXXXXXXXXXXXXXXXXXXXXXXXXXXXXXXXXXXXXXXXXXXXXXXXXXXXXXXXXXXXXXXXXXXXXXXXXXXXXXXXXXXXXXXXXX
