XXXXXXXXXXXXXXXXXXXXXXXXXXXXXXXXXXXXXXXXXXXXXXXXXXXXXXXXXXXXXXXXXXXXXXXXXXXXXXXXXXXXXXXXXXXXXXXXXXXXXXXXXXXXXXXXXXXXXXXXXXXXXXXXXXXXXXXXXXXXXXXXXXXXXXXXXXXXXXXXXXXXXXXXXXXXXXXXXXXXXXXXXXXXXXXXXXXXXXXXXXXXXXXXXXXXXXXXXXXX
----------------[]------[]------[]------[]------[]------[]------[]------[]------[]------[]------[]------[]------[]------[]------[]------[]------[]------[]------[]------[]------[]------[]------[]------[]------[]----------
----------------<>------<>------[]------[]------[]------<>------[]------[]------[]------[]------[]------[]------[]------[]------[]------<>------[]------[]------[]------[]------[]------[]------[]------[]------[]----------
--------------------------------[]------<>------[]--------------[]------<>------<>------[]------[]------[]------[]------[]------<>--------------[]------[]------[]------[]------[]------<>------[]------<>------[]----------
--------------------------------<>--------------[]--------------<>----------------------<>------[]------[]------[]------<>----------------------[]------[]------<>------<>------<>--------------[]--------------[]----------
------------------------------------------------[]----------------------------------------------<>------<>------<>----------------------<>------[]------<>--------------------------------------[]--------------[]----------
----------------------------------------<>------<>------------------------------<>----------------------------------------------<>------[]------[]--------------------------------------<>------<>------<>------<>----------
----------------------------------------[]------------------------------<>------[]----------------------------------------------[]------[]------[]------------------------------<>------[]--------------[]------------------
----------------------------------------[]----------------------<>------[]------[]----------------------<>------<>------<>------[]------[]------<>------<>------<>--------------[]------[]--------------[]------------------
------------------------<>--------------[]------<>--------------[]------[]------[]----------------------[]------[]------[]------[]------[]--------------[]------[]--------------[]------[]------<>------[]------<>----------
------------------------[]--------------[]------[]------<>------[]------[]------[]--------------<>------[]------[]------[]------[]------[]--------------[]------[]--------------[]------[]------[]------[]------[]----------
----------------<>------[]------<>------[]------[]------[]------[]------[]------[]------<>------[]------[]------[]------[]------[]------[]------<>------[]------[]------<>------[]------[]------[]------[]------[]----------
----------------[]------[]------[]------[]------[]------[]------[]------[]------[]------[]------[]------[]------[]------[]------[]------[]------[]------[]------[]------[]------[]------[]------[]------[]------[]----------
XXXXXXXXXXXXXXXXXXXXXXXXXXXXXXXXXXXXXXXXXXXXXXXXXXXXXXXXXXXXXXXXXXXXXXXXXXXXXXXXXXXXXXXXXXXXXXXXXXXXXXXXXXXXXXXXXXXXXXXXXXXXXXXXXXXXXXXXXXXXXXXXXXXXXXXXXXXXXXXXXXXXXXXXXXXXXXXXXXXXXXXXXXXXXXXXXXXXXXXXXXXXXXXXXXXXXXXXXXXX
