XXXXXXXXXXXXXXXXXXXXXXXXXXXXXXXXXXXXXXXXXXXXXXXXXXXXXXXXXXXXXXXXXXXXXXXXXXXXXXXXXXXXXXXXXXXXXXXXXXXXXXXXXXXXXXXXXXXXXXXXXXXXXXXXXXXXXXXXXXXXXXXXXXXXXXXXXXXXXXXXXXXXXXXXXXXXXXXXXXXXXXXXXXXXXXXXXXXXXXXXXXXXXXXXXXXXXXXXXXXX
----------------[]------[]------[]------[]------[]------[]------[]------[]------[]------[]------[]------[]------[]------[]------[]------[]------[]------[]------[]------[]------[]------[]------[]------[]------[]----------
----------------<>------<>------[]------[]------[]------[]------[]------[]------[]------[]------[]------[]------[]------[]------[]------<>------<>------[]------<>------[]------<>------<>------[]------[]------<>----------
--------------------------------[]------<>------[]------[]------[]------[]------[]------[]------[]------[]------<>------<>------[]----------------------<>--------------<>----------------------<>------[]------------------
--------------------------------<>--------------[]------<>------[]------[]------[]------[]------[]------<>----------------------[]----------------------------------------------------------------------[]------------------
------------------------<>----------------------[]--------------<>------<>------<>------[]------[]------------------------------<>--------------<>--------------<>--------------<>----------------------[]------------------
----------------<>------[]----------------------<>--------------------------------------[]------[]----------------------<>----------------------[]------<>------[]--------------[]------<>--------------[]------------------
----------------[]------[]--------------------------------------------------------------<>------<>------<>------<>------[]--------------<>------[]------[]------[]--------------[]------[]--------------<>------------------
----------------[]------[]--------------------------------------<>------<>------<>----------------------[]------[]------[]--------------[]------[]------[]------[]--------------[]------[]------<>--------------------------
----------------[]------[]------<>------------------------------[]------[]------[]----------------------[]------[]------[]------<>------[]------[]------[]------[]------<>------[]------[]------[]--------------<>----------
----------------[]------[]------[]------<>--------------<>------[]------[]------[]--------------<>------[]------[]------[]------[]------[]------[]------[]------[]------[]------[]------[]------[]--------------[]----------
----------------[]------[]------[]------[]------<>------[]------[]------[]------[]------<>------[]------[]------[]------[]------[]------[]------[]------[]------[]------[]------[]------[]------[]------<>------[]----------
----------------[]------[]------[]------[]------[]------[]------[]------[]------[]------[]------[]------[]------[]------[]------[]------[]------[]------[]------[]------[]------[]------[]------[]------[]------[]----------
XXXXXXXXXXXXXXXXXXXXXXXXXXXXXXXXXXXXXXXXXXXXXXXXXXXXXXXXXXXXXXXXXXXXXXXXXXXXXXXXXXXXXXXXXXXXXXXXXXXXXXXXXXXXXXXXXXXXXXXXXXXXXXXXXXXXXXXXXXXXXXXXXXXXXXXXXXXXXXXXXXXXXXXXXXXXXXXXXXXXXXXXXXXXXXXXXXXXXXXXXXXXXXXXXXXXXXXXXXXX
