XXXXXXXXXXXXXXXXXXXXXXXXXXXXXXXXXXXXXXXXXXXXXXXXXXXXXXXXXXXXXXXXXXXXXXXXXXXXXXXXXXXXXXXXXXXXXXXXXXXXXXXXXXXXXXXXXXXXXXXXXXXXXXXXXXXXXXXXXXXXXXXXXXXXXXXXXXXXXXXXXXXXXXXXXXXXXXXXXXXXXXXXXXXXXXXXXXXXXXXXXXXXXXXXXXXXXXXXXXXX
----------------[]------[]------[]------[]------[]------[]------[]------[]------[]------[]------[]------[]------[]------[]------[]------[]------[]------[]------[]------[]------[]------[]------[]------[]------[]----------
----------------<>------<>------<>------[]------[]------[]------<>------<>------[]------[]------<>------[]------[]------[]------<>------[]------<>------<>------<>------[]------[]------[]------[]------[]------[]----------
----------------------------------------<>------[]------[]----------------------<>------[]--------------[]------<>------[]--------------[]------------------------------[]------[]------<>------[]------[]------<>----------
------------------------------------------------<>------<>------------------------------<>--------------<>--------------[]--------------<>------------------------------<>------<>--------------<>------[]------------------
----------------------------------------------------------------<>------<>----------------------<>----------------------[]----------------------<>------<>------<>--------------------------------------[]------------------
--------------------------------<>------<>----------------------[]------[]------<>--------------[]--------------<>------<>----------------------[]------[]------[]--------------------------------------[]------------------
----------------<>------<>------[]------[]------<>------<>------[]------[]------[]--------------[]--------------[]----------------------<>------[]------[]------[]------<>------------------------------[]------<>----------
----------------[]------[]------[]------[]------[]------[]------[]------[]------[]------<>------[]--------------[]--------------<>------[]------[]------[]------[]------[]------------------------------<>------[]----------
----------------[]------[]------[]------[]------[]------[]------[]------[]------[]------[]------[]--------------[]------<>------[]------[]------[]------[]------[]------[]------<>------------------------------[]----------
----------------[]------[]------[]------[]------[]------[]------[]------[]------[]------[]------[]--------------[]------[]------[]------[]------[]------[]------[]------[]------[]------<>------<>--------------[]----------
----------------[]------[]------[]------[]------[]------[]------[]------[]------[]------[]------[]------<>------[]------[]------[]------[]------[]------[]------[]------[]------[]------[]------[]------<>------[]----------
----------------[]------[]------[]------[]------[]------[]------[]------[]------[]------[]------[]------[]------[]------[]------[]------[]------[]------[]------[]------[]------[]------[]------[]------[]------[]----------
XXXXXXXXXXXXXXXXXXXXXXXXXXXXXXXXXXXXXXXXXXXXXXXXXXXXXXXXXXXXXXXXXXXXXXXXXXXXXXXXXXXXXXXXXXXXXXXXXXXXXXXXXXXXXXXXXXXXXXXXXXXXXXXXXXXXXXXXXXXXXXXXXXXXXXXXXXXXXXXXXXXXXXXXXXXXXXXXXXXXXXXXXXXXXXXXXXXXXXXXXXXXXXXXXXXXXXXXXXXX
