XXXXXXXXXXXXXXXXXXXXXXXXXXXXXXXXXXXXXXXXXXXXXXXXXXXXXXXXXXXXXXXXXXXXXXXXXXXXXXXXXXXXXXXXXXXXXXXXXXXXXXXXXXXXXXXXXXXXXXXXXXXXXXXXXXXXXXXXXXXXXXXXXXXXXXXXXXXXXXXXXXXXXXXXXXXXXXXXXXXXXXXXXXXXXXXXXXXXXXXXXXXXXXXXXXXXXXXXXXXX
----------------[]------[]------[]------[]------[]------[]------[]------[]------[]------[]------[]------[]------[]------[]------[]------[]------[]------[]------[]------[]------[]------[]------[]------[]------[]----------
----------------[]------<>------[]------[]------[]------[]------[]------<>------[]------[]------<>------[]------[]------[]------[]------<>------[]------<>------[]------[]------[]------[]------[]------[]------[]----------
----------------[]--------------[]------<>------[]------[]------<>--------------[]------[]--------------[]------[]------[]------[]--------------[]--------------[]------[]------<>------[]------[]------<>------<>----------
----------------[]--------------[]--------------[]------<>----------------------[]------[]--------------<>------[]------[]------<>--------------[]--------------[]------[]--------------[]------<>--------------------------
----------------<>--------------[]--------------<>----------------------<>------[]------<>----------------------[]------[]--------------<>------[]--------------[]------<>--------------<>----------------------------------
--------------------------------<>--------------------------------------[]------<>------------------------------[]------[]--------------[]------[]--------------<>----------------------------------------------------------
------------------------------------------------------------------------[]----------------------<>--------------[]------<>------<>------[]------<>------<>--------------------------------------<>------<>------<>----------
----------------<>------<>--------------------------------------<>------[]--------------<>------[]--------------<>--------------[]------[]--------------[]----------------------<>--------------[]------[]------[]----------
----------------[]------[]--------------<>--------------<>------[]------[]--------------[]------[]------------------------------[]------[]--------------[]----------------------[]------<>------[]------[]------[]----------
----------------[]------[]------<>------[]------<>------[]------[]------[]--------------[]------[]------------------------------[]------[]--------------[]------<>------<>------[]------[]------[]------[]------[]----------
----------------[]------[]------[]------[]------[]------[]------[]------[]------<>------[]------[]------<>------<>------<>------[]------[]------<>------[]------[]------[]------[]------[]------[]------[]------[]----------
----------------[]------[]------[]------[]------[]------[]------[]------[]------[]------[]------[]------[]------[]------[]------[]------[]------[]------[]------[]------[]------[]------[]------[]------[]------[]----------
XXXXXXXXXXXXXXXXXXXXXXXXXXXXXXXXXXXXXXXXXXXXXXXXXXXXXXXXXXXXXXXXXXXXXXXXXXXXXXXXXXXXXXXXXXXXXXXXXXXXXXXXXXXXXXXXXXXXXXXXXXXXXXXXXXXXXXXXXXXXXXXXXXXXXXXXXXXXXXXXXXXXXXXXXXXXXXXXXXXXXXXXXXXXXXXXXXXXXXXXXXXXXXXXXXXXXXXXXXXX
