XXXXXXXXXXXXXXXXXXXXXXXXXXXXXXXXXXXXXXXXXXXXXXXXXXXXXXXXXXXXXXXXXXXXXXXXXXXXXXXXXXXXXXXXXXXXXXXXXXXXXXXXXXXXXXXXXXXXXXXXXXXXXXXXXXXXXXXXXXXXXXXXXXXXXXXXXXXXXXXXXXXXXXXXXXXXXXXXXXXXXXXXXXXXXXXXXXXXXXXXXXXXXXXXXXXXXXXXXXXX
----------------[]------[]------[]------[]------[]------[]------[]------[]------[]------[]------[]------[]------[]------[]------[]------[]------[]------[]------[]------[]------[]------[]------[]------[]------[]----------
----------------<>------<>------[]------<>------<>------<>------[]------[]------<>------<>------<>------<>------<>------[]------<>------<>------[]------[]------[]------[]------[]------[]------[]------[]------[]----------
--------------------------------[]------------------------------[]------[]----------------------------------------------[]----------------------<>------[]------[]------<>------[]------[]------[]------[]------[]----------
--------------------------------[]------------------------------[]------<>----------------------------------------------<>------------------------------<>------[]--------------<>------[]------[]------[]------[]----------
--------------------------------<>------<>--------------<>------[]----------------------<>--------------<>----------------------<>------------------------------[]----------------------[]------[]------<>------[]----------
----------------------------------------[]--------------[]------[]----------------------[]--------------[]----------------------[]------------------------------<>----------------------<>------<>--------------[]----------
----------------------------------------[]--------------[]------<>--------------<>------[]--------------[]----------------------[]------<>----------------------------------------------------------------------<>----------
----------------<>------<>--------------[]--------------[]----------------------[]------[]--------------[]----------------------[]------[]--------------------------------------------------------------<>------------------
----------------[]------[]------<>------[]--------------[]----------------------[]------[]------<>------[]----------------------[]------[]----------------------<>------<>--------------<>------<>------[]------------------
----------------[]------[]------[]------[]--------------[]----------------------[]------[]------[]------[]------<>------<>------[]------[]------<>------<>------[]------[]--------------[]------[]------[]------------------
----------------[]------[]------[]------[]------<>------[]------<>------<>------[]------[]------[]------[]------[]------[]------[]------[]------[]------[]------[]------[]------<>------[]------[]------[]------<>----------
----------------[]------[]------[]------[]------[]------[]------[]------[]------[]------[]------[]------[]------[]------[]------[]------[]------[]------[]------[]------[]------[]------[]------[]------[]------[]----------
XXXXXXXXXXXXXXXXXXXXXXXXXXXXXXXXXXXXXXXXXXXXXXXXXXXXXXXXXXXXXXXXXXXXXXXXXXXXXXXXXXXXXXXXXXXXXXXXXXXXXXXXXXXXXXXXXXXXXXXXXXXXXXXXXXXXXXXXXXXXXXXXXXXXXXXXXXXXXXXXXXXXXXXXXXXXXXXXXXXXXXXXXXXXXXXXXXXXXXXXXXXXXXXXXXXXXXXXXXXX
