XXXXXXXXXXXXXXXXXXXXXXXXXXXXXXXXXXXXXXXXXXXXXXXXXXXXXXXXXXXXXXXXXXXXXXXXXXXXXXXXXXXXXXXXXXXXXXXXXXXXXXXXXXXXXXXXXXXXXXXXXXXXXXXXXXXXXXXXXXXXXXXXXXXXXXXXXXXXXXXXXXXXXXXXXXXXXXXXXXXXXXXXXXXXXXXXXXXXXXXXXXXXXXXXXXXXXXXXXXXX
----------------[]------[]------[]------[]------[]------[]------[]------[]------[]------[]------[]------[]------[]------[]------[]------[]------[]------[]------[]------[]------[]------[]------[]------[]------[]----------
----------------[]------<>------[]------<>------<>------[]------[]------[]------[]------[]------<>------[]------[]------[]------[]------[]------[]------[]------<>------<>------<>------[]------[]------[]------[]----------
----------------<>--------------<>----------------------[]------<>------[]------<>------[]--------------<>------[]------[]------[]------[]------<>------[]------------------------------[]------[]------<>------[]----------
--------------------------------------------------------<>--------------<>--------------[]----------------------[]------[]------[]------[]--------------<>------------------------------[]------<>--------------[]----------
------------------------<>--------------------------------------------------------------[]----------------------[]------<>------[]------[]----------------------------------------------[]----------------------[]----------
------------------------[]--------------------------------------------------------------<>--------------<>------[]--------------[]------[]----------------------------------------------<>----------------------[]----------
------------------------[]------------------------------<>----------------------<>----------------------[]------[]--------------<>------[]----------------------<>--------------<>----------------------<>------[]----------
------------------------[]------<>------<>--------------[]------<>--------------[]----------------------[]------<>----------------------<>------<>--------------[]--------------[]----------------------[]------<>----------
----------------<>------[]------[]------[]------<>------[]------[]--------------[]--------------<>------[]--------------<>----------------------[]--------------[]--------------[]----------------------[]------------------
----------------[]------[]------[]------[]------[]------[]------[]--------------[]--------------[]------[]--------------[]----------------------[]--------------[]--------------[]------<>------<>------[]------------------
----------------[]------[]------[]------[]------[]------[]------[]------<>------[]------<>------[]------[]------<>------[]------<>------<>------[]------<>------[]------<>------[]------[]------[]------[]------<>----------
----------------[]------[]------[]------[]------[]------[]------[]------[]------[]------[]------[]------[]------[]------[]------[]------[]------[]------[]------[]------[]------[]------[]------[]------[]------[]----------
XXXXXXXXXXXXXXXXXXXXXXXXXXXXXXXXXXXXXXXXXXXXXXXXXXXXXXXXXXXXXXXXXXXXXXXXXXXXXXXXXXXXXXXXXXXXXXXXXXXXXXXXXXXXXXXXXXXXXXXXXXXXXXXXXXXXXXXXXXXXXXXXXXXXXXXXXXXXXXXXXXXXXXXXXXXXXXXXXXXXXXXXXXXXXXXXXXXXXXXXXXXXXXXXXXXXXXXXXXXX
