XXXXXXXXXXXXXXXXXXXXXXXXXXXXXXXXXXXXXXXXXXXXXXXXXXXXXXXXXXXXXXXXXXXXXXXXXXXXXXXXXXXXXXXXXXXXXXXXXXXXXXXXXXXXXXXXXXXXXXXXXXXXXXXXXXXXXXXXXXXXXXXXXXXXXXXXXXXXXXXXXXXXXXXXXXXXXXXXXXXXXXXXXXXXXXXXXXXXXXXXXXXXXXXXXXXXXXXXXXXX
----------------[]------[]------[]------[]------[]------[]------[]------[]------[]------[]------[]------[]------[]------[]------[]------[]------[]------[]------[]------[]------[]------[]------[]------[]------[]----------
----------------[]------[]------[]------<>------[]------[]------[]------[]------[]------[]------[]------<>------[]------<>------<>------<>------[]------<>------<>------<>------[]------[]------[]------[]------[]----------
----------------<>------[]------<>--------------[]------<>------[]------[]------<>------[]------<>--------------<>------------------------------<>------------------------------[]------[]------[]------<>------[]----------
------------------------[]----------------------<>--------------[]------<>--------------<>--------------------------------------------------------------------------------------[]------[]------[]--------------[]----------
------------------------[]--------------<>----------------------<>------------------------------------------------------<>------<>------<>--------------------------------------<>------[]------<>--------------<>----------
----------------<>------[]--------------[]--------------<>----------------------------------------------<>--------------[]------[]------[]------<>--------------------------------------<>----------------------------------
----------------[]------<>--------------[]------<>------[]--------------------------------------<>------[]------<>------[]------[]------[]------[]------<>------<>--------------------------------------<>------------------
----------------[]----------------------[]------[]------[]------------------------------<>------[]------[]------[]------[]------[]------[]------[]------[]------[]------<>------------------------------[]------------------
----------------[]----------------------[]------[]------[]--------------<>--------------[]------[]------[]------[]------[]------[]------[]------[]------[]------[]------[]--------------<>--------------[]------------------
----------------[]------<>------<>------[]------[]------[]------<>------[]------<>------[]------[]------[]------[]------[]------[]------[]------[]------[]------[]------[]--------------[]------<>------[]------------------
----------------[]------[]------[]------[]------[]------[]------[]------[]------[]------[]------[]------[]------[]------[]------[]------[]------[]------[]------[]------[]------<>------[]------[]------[]------<>----------
----------------[]------[]------[]------[]------[]------[]------[]------[]------[]------[]------[]------[]------[]------[]------[]------[]------[]------[]------[]------[]------[]------[]------[]------[]------[]----------
XXXXXXXXXXXXXXXXXXXXXXXXXXXXXXXXXXXXXXXXXXXXXXXXXXXXXXXXXXXXXXXXXXXXXXXXXXXXXXXXXXXXXXXXXXXXXXXXXXXXXXXXXXXXXXXXXXXXXXXXXXXXXXXXXXXXXXXXXXXXXXXXXXXXXXXXXXXXXXXXXXXXXXXXXXXXXXXXXXXXXXXXXXXXXXXXXXXXXXXXXXXXXXXXXXXXXXXXXXXX
