XXXXXXXXXXXXXXXXXXXXXXXXXXXXXXXXXXXXXXXXXXXXXXXXXXXXXXXXXXXXXXXXXXXXXXXXXXXXXXXXXXXXXXXXXXXXXXXXXXXXXXXXXXXXXXXXXXXXXXXXXXXXXXXXXXXXXXXXXXXXXXXXXXXXXXXXXXXXXXXXXXXXXXXXXXXXXXXXXXXXXXXXXXXXXXXXXXXXXXXXXXXXXXXXXXXXXXXXXXXX
----------------[]------[]------[]------[]------[]------[]------[]------[]------[]------[]------[]------[]------[]------[]------[]------[]------[]------[]------[]------[]------[]------[]------[]------[]------[]----------
----------------[]------[]------<>------<>------[]------[]------[]------<>------[]------[]------<>------[]------<>------[]------[]------<>------[]------[]------[]------<>------[]------[]------<>------<>------[]----------
----------------[]------[]----------------------<>------[]------[]--------------<>------<>--------------[]--------------[]------[]--------------[]------[]------<>--------------<>------[]----------------------<>----------
----------------<>------[]------------------------------[]------[]--------------------------------------[]--------------[]------[]--------------[]------[]------------------------------[]----------------------------------
------------------------[]--------------<>--------------<>------<>------<>----------------------<>------[]--------------<>------<>--------------[]------[]--------------<>--------------<>------<>------<>------------------
------------------------[]--------------[]------------------------------[]----------------------[]------[]--------------------------------------<>------<>------<>------[]------<>--------------[]------[]------<>----------
------------------------<>--------------[]------<>----------------------[]----------------------[]------<>------------------------------------------------------[]------[]------[]--------------[]------[]------[]----------
----------------------------------------[]------[]----------------------[]----------------------[]--------------------------------------<>----------------------[]------[]------[]--------------[]------[]------[]----------
----------------<>--------------<>------[]------[]----------------------[]----------------------[]----------------------<>------<>------[]------<>--------------[]------[]------[]--------------[]------[]------[]----------
----------------[]--------------[]------[]------[]----------------------[]------<>------<>------[]--------------<>------[]------[]------[]------[]------<>------[]------[]------[]------<>------[]------[]------[]----------
----------------[]------<>------[]------[]------[]------<>------<>------[]------[]------[]------[]------<>------[]------[]------[]------[]------[]------[]------[]------[]------[]------[]------[]------[]------[]----------
----------------[]------[]------[]------[]------[]------[]------[]------[]------[]------[]------[]------[]------[]------[]------[]------[]------[]------[]------[]------[]------[]------[]------[]------[]------[]----------
XXXXXXXXXXXXXXXXXXXXXXXXXXXXXXXXXXXXXXXXXXXXXXXXXXXXXXXXXXXXXXXXXXXXXXXXXXXXXXXXXXXXXXXXXXXXXXXXXXXXXXXXXXXXXXXXXXXXXXXXXXXXXXXXXXXXXXXXXXXXXXXXXXXXXXXXXXXXXXXXXXXXXXXXXXXXXXXXXXXXXXXXXXXXXXXXXXXXXXXXXXXXXXXXXXXXXXXXXXXX
