XXXXXXXXXXXXXXXXXXXXXXXXXXXXXXXXXXXXXXXXXXXXXXXXXXXXXXXXXXXXXXXXXXXXXXXXXXXXXXXXXXXXXXXXXXXXXXXXXXXXXXXXXXXXXXXXXXXXXXXXXXXXXXXXXXXXXXXXXXXXXXXXXXXXXXXXXXXXXXXXXXXXXXXXXXXXXXXXXXXXXXXXXXXXXXXXXXXXXXXXXXXXXXXXXXXXXXXXXXXX
----------------[]------[]------[]------[]------[]------[]------[]------[]------[]------[]------[]------[]------[]------[]------[]------[]------[]------[]------[]------[]------[]------[]------[]------[]------[]----------
----------------<>------<>------<>------<>------[]------<>------[]------<>------<>------<>------[]------[]------<>------[]------[]------<>------[]------[]------[]------<>------[]------[]------<>------<>------[]----------
------------------------------------------------<>--------------<>------------------------------[]------[]--------------[]------<>--------------[]------[]------[]--------------[]------[]----------------------<>----------
------------------------------------------------------------------------------------------------<>------<>--------------[]----------------------[]------[]------[]--------------[]------[]----------------------------------
----------------<>--------------<>----------------------<>------------------------------------------------------<>------[]----------------------[]------[]------<>------<>------<>------[]------<>--------------------------
----------------[]------<>------[]------<>--------------[]------<>------<>------<>------<>----------------------[]------[]----------------------<>------<>--------------[]--------------<>------[]------<>------------------
----------------[]------[]------[]------[]--------------[]------[]------[]------[]------[]------<>------<>------[]------[]--------------<>------------------------------[]----------------------[]------[]------------------
----------------[]------[]------[]------[]--------------[]------[]------[]------[]------[]------[]------[]------[]------<>------<>------[]------------------------------[]----------------------[]------[]------------------
----------------[]------[]------[]------[]------<>------[]------[]------[]------[]------[]------[]------[]------[]--------------[]------[]--------------<>------<>------[]----------------------[]------[]------<>----------
----------------[]------[]------[]------[]------[]------[]------[]------[]------[]------[]------[]------[]------[]--------------[]------[]--------------[]------[]------[]--------------<>------[]------[]------[]----------
----------------[]------[]------[]------[]------[]------[]------[]------[]------[]------[]------[]------[]------[]------<>------[]------[]------<>------[]------[]------[]------<>------[]------[]------[]------[]----------
----------------[]------[]------[]------[]------[]------[]------[]------[]------[]------[]------[]------[]------[]------[]------[]------[]------[]------[]------[]------[]------[]------[]------[]------[]------[]----------
XXXXXXXXXXXXXXXXXXXXXXXXXXXXXXXXXXXXXXXXXXXXXXXXXXXXXXXXXXXXXXXXXXXXXXXXXXXXXXXXXXXXXXXXXXXXXXXXXXXXXXXXXXXXXXXXXXXXXXXXXXXXXXXXXXXXXXXXXXXXXXXXXXXXXXXXXXXXXXXXXXXXXXXXXXXXXXXXXXXXXXXXXXXXXXXXXXXXXXXXXXXXXXXXXXXXXXXXXXXX
