XXXXXXXXXXXXXXXXXXXXXXXXXXXXXXXXXXXXXXXXXXXXXXXXXXXXXXXXXXXXXXXXXXXXXXXXXXXXXXXXXXXXXXXXXXXXXXXXXXXXXXXXXXXXXXXXXXXXXXXXXXXXXXXXXXXXXXXXXXXXXXXXXXXXXXXXXXXXXXXXXXXXXXXXXXXXXXXXXXXXXXXXXXXXXXXXXXXXXXXXXXXXXXXXXXXXXXXXXXXX
----------------[]------[]------[]------[]------[]------[]------[]------[]------[]------[]------[]------[]------[]------[]------[]------[]------[]------[]------[]------[]------[]------[]------[]------[]------[]----------
----------------[]------[]------[]------[]------<>------[]------[]------[]------<>------[]------<>------<>------<>------<>------[]------[]------<>------<>------[]------<>------[]------[]------[]------[]------[]----------
----------------<>------[]------<>------<>--------------<>------[]------[]--------------[]--------------------------------------[]------[]----------------------[]--------------<>------[]------<>------[]------[]----------
------------------------[]--------------------------------------<>------[]--------------[]--------------------------------------[]------[]----------------------<>----------------------[]--------------<>------[]----------
------------------------[]----------------------------------------------[]--------------<>------<>------<>------<>------<>------<>------[]------------------------------<>--------------[]----------------------[]----------
------------------------<>----------------------------------------------[]------<>--------------[]------[]------[]------[]--------------<>------<>----------------------[]--------------[]----------------------<>----------
--------------------------------<>------------------------------<>------<>------[]--------------[]------[]------[]------[]----------------------[]------<>--------------[]--------------<>--------------<>------------------
--------------------------------[]------------------------------[]--------------[]--------------[]------[]------[]------[]----------------------[]------[]--------------[]----------------------<>------[]------------------
--------------------------------[]--------------<>------<>------[]--------------[]--------------[]------[]------[]------[]--------------<>------[]------[]--------------[]----------------------[]------[]------------------
----------------<>--------------[]--------------[]------[]------[]------<>------[]------<>------[]------[]------[]------[]--------------[]------[]------[]------<>------[]--------------<>------[]------[]------------------
----------------[]------<>------[]------<>------[]------[]------[]------[]------[]------[]------[]------[]------[]------[]------<>------[]------[]------[]------[]------[]------<>------[]------[]------[]------<>----------
----------------[]------[]------[]------[]------[]------[]------[]------[]------[]------[]------[]------[]------[]------[]------[]------[]------[]------[]------[]------[]------[]------[]------[]------[]------[]----------
XXXXXXXXXXXXXXXXXXXXXXXXXXXXXXXXXXXXXXXXXXXXXXXXXXXXXXXXXXXXXXXXXXXXXXXXXXXXXXXXXXXXXXXXXXXXXXXXXXXXXXXXXXXXXXXXXXXXXXXXXXXXXXXXXXXXXXXXXXXXXXXXXXXXXXXXXXXXXXXXXXXXXXXXXXXXXXXXXXXXXXXXXXXXXXXXXXXXXXXXXXXXXXXXXXXXXXXXXXXX
