XXXXXXXXXXXXXXXXXXXXXXXXXXXXXXXXXXXXXXXXXXXXXXXXXXXXXXXXXXXXXXXXXXXXXXXXXXXXXXXXXXXXXXXXXXXXXXXXXXXXXXXXXXXXXXXXXXXXXXXXXXXXXXXXXXXXXXXXXXXXXXXXXXXXXXXXXXXXXXXXXXXXXXXXXXXXXXXXXXXXXXXXXXXXXXXXXXXXXXXXXXXXXXXXXXXXXXXXXXXX
----------------[]------[]------[]------[]------[]------[]------[]------[]------[]------[]------[]------[]------[]------[]------[]------[]------[]------[]------[]------[]------[]------[]------[]------[]------[]----------
----------------<>------[]------<>------<>------<>------<>------[]------[]------<>------[]------[]------[]------[]------[]------[]------[]------<>------[]------[]------<>------[]------<>------<>------[]------[]----------
------------------------<>--------------------------------------<>------[]--------------[]------[]------<>------<>------[]------[]------[]--------------[]------<>--------------[]----------------------<>------[]----------
------------------------------------------------------------------------[]--------------[]------[]----------------------<>------[]------[]--------------<>----------------------<>------------------------------[]----------
----------------<>------------------------------<>----------------------[]--------------[]------<>------------------------------<>------<>------------------------------------------------------<>--------------<>----------
----------------[]--------------<>------<>------[]------<>--------------[]------<>------[]------------------------------------------------------<>----------------------------------------------[]------<>------------------
----------------[]--------------[]------[]------[]------[]--------------<>------[]------<>----------------------<>------------------------------[]--------------<>------------------------------[]------[]------------------
----------------[]--------------[]------[]------[]------[]----------------------[]------------------------------[]------<>----------------------[]--------------[]------<>------<>--------------[]------[]------<>----------
----------------[]--------------[]------[]------[]------[]----------------------[]--------------<>--------------[]------[]--------------<>------[]--------------[]------[]------[]--------------[]------[]------[]----------
----------------[]------<>------[]------[]------[]------[]--------------<>------[]------<>------[]--------------[]------[]------<>------[]------[]--------------[]------[]------[]------<>------[]------[]------[]----------
----------------[]------[]------[]------[]------[]------[]------<>------[]------[]------[]------[]------<>------[]------[]------[]------[]------[]------<>------[]------[]------[]------[]------[]------[]------[]----------
----------------[]------[]------[]------[]------[]------[]------[]------[]------[]------[]------[]------[]------[]------[]------[]------[]------[]------[]------[]------[]------[]------[]------[]------[]------[]----------
XXXXXXXXXXXXXXXXXXXXXXXXXXXXXXXXXXXXXXXXXXXXXXXXXXXXXXXXXXXXXXXXXXXXXXXXXXXXXXXXXXXXXXXXXXXXXXXXXXXXXXXXXXXXXXXXXXXXXXXXXXXXXXXXXXXXXXXXXXXXXXXXXXXXXXXXXXXXXXXXXXXXXXXXXXXXXXXXXXXXXXXXXXXXXXXXXXXXXXXXXXXXXXXXXXXXXXXXXXXX
