XXXXXXXXXXXXXXXXXXXXXXXXXXXXXXXXXXXXXXXXXXXXXXXXXXXXXXXXXXXXXXXXXXXXXXXXXXXXXXXXXXXXXXXXXXXXXXXXXXXXXXXXXXXXXXXXXXXXXXXXXXXXXXXXXXXXXXXXXXXXXXXXXXXXXXXXXXXXXXXXXXXXXXXXXXXXXXXXXXXXXXXXXXXXXXXXXXXXXXXXXXXXXXXXXXXXXXXXXXXX
----------------[]------[]------[]------[]------[]------[]------[]------[]------[]------[]------[]------[]------[]------[]------[]------[]------[]------[]------[]------[]------[]------[]------[]------[]------[]----------
----------------[]------[]------<>------[]------[]------<>------<>------[]------[]------[]------[]------[]------[]------[]------[]------<>------[]------[]------<>------<>------<>------[]------[]------<>------[]----------
----------------<>------[]--------------[]------[]----------------------[]------[]------<>------[]------[]------[]------[]------[]--------------[]------[]------------------------------[]------[]--------------[]----------
------------------------<>--------------[]------[]----------------------[]------<>--------------[]------[]------[]------<>------[]--------------<>------[]------------------------------<>------<>--------------[]----------
--------------------------------<>------[]------[]----------------------<>----------------------[]------[]------[]--------------[]----------------------[]------<>--------------------------------------<>------[]----------
--------------------------------[]------[]------[]------<>------<>------------------------------<>------<>------<>--------------<>------<>--------------<>------[]--------------------------------------[]------[]----------
--------------------------------[]------<>------<>------[]------[]----------------------<>----------------------------------------------[]----------------------[]------<>----------------------<>------[]------<>----------
----------------<>------<>------[]----------------------[]------[]------<>--------------[]------------------------------<>--------------[]------<>--------------[]------[]----------------------[]------[]------------------
----------------[]------[]------[]----------------------[]------[]------[]--------------[]----------------------<>------[]--------------[]------[]------<>------[]------[]----------------------[]------[]------------------
----------------[]------[]------[]--------------<>------[]------[]------[]------<>------[]------<>--------------[]------[]--------------[]------[]------[]------[]------[]--------------<>------[]------[]------<>----------
----------------[]------[]------[]------<>------[]------[]------[]------[]------[]------[]------[]------<>------[]------[]------<>------[]------[]------[]------[]------[]------<>------[]------[]------[]------[]----------
----------------[]------[]------[]------[]------[]------[]------[]------[]------[]------[]------[]------[]------[]------[]------[]------[]------[]------[]------[]------[]------[]------[]------[]------[]------[]----------
XXXXXXXXXXXXXXXXXXXXXXXXXXXXXXXXXXXXXXXXXXXXXXXXXXXXXXXXXXXXXXXXXXXXXXXXXXXXXXXXXXXXXXXXXXXXXXXXXXXXXXXXXXXXXXXXXXXXXXXXXXXXXXXXXXXXXXXXXXXXXXXXXXXXXXXXXXXXXXXXXXXXXXXXXXXXXXXXXXXXXXXXXXXXXXXXXXXXXXXXXXXXXXXXXXXXXXXXXXXX
