XXXXXXXXXXXXXXXXXXXXXXXXXXXXXXXXXXXXXXXXXXXXXXXXXXXXXXXXXXXXXXXXXXXXXXXXXXXXXXXXXXXXXXXXXXXXXXXXXXXXXXXXXXXXXXXXXXXXXXXXXXXXXXXXXXXXXXXXXXXXXXXXXXXXXXXXXXXXXXXXXXXXXXXXXXXXXXXXXXXXXXXXXXXXXXXXXXXXXXXXXXXXXXXXXXXXXXXXXXXX
----------------[]------[]------[]------[]------[]------[]------[]------[]------[]------[]------[]------[]------[]------[]------[]------[]------[]------[]------[]------[]------[]------[]------[]------[]------[]----------
----------------<>------[]------<>------<>------[]------[]------<>------[]------<>------[]------[]------[]------[]------<>------[]------[]------<>------[]------[]------[]------[]------[]------<>------[]------[]----------
------------------------[]----------------------[]------[]--------------[]--------------[]------[]------[]------[]--------------<>------<>--------------<>------[]------[]------<>------[]--------------<>------[]----------
------------------------[]----------------------[]------[]--------------[]--------------[]------[]------<>------[]----------------------------------------------[]------[]--------------[]----------------------<>----------
------------------------[]----------------------[]------[]--------------<>--------------[]------<>--------------<>------<>----------------------<>--------------[]------[]--------------[]----------------------------------
------------------------<>--------------<>------<>------<>----------------------<>------[]------------------------------[]------<>--------------[]--------------[]------[]--------------<>------<>------<>------------------
----------------------------------------[]--------------------------------------[]------<>------------------------------[]------[]--------------[]--------------[]------<>------<>--------------[]------[]------------------
----------------<>--------------<>------[]----------------------<>------<>------[]------------------------------<>------[]------[]--------------[]------<>------<>--------------[]--------------[]------[]------------------
----------------[]--------------[]------[]------<>--------------[]------[]------[]--------------<>------<>------[]------[]------[]--------------[]------[]----------------------[]--------------[]------[]------<>----------
----------------[]------<>------[]------[]------[]--------------[]------[]------[]--------------[]------[]------[]------[]------[]------<>------[]------[]----------------------[]--------------[]------[]------[]----------
----------------[]------[]------[]------[]------[]------<>------[]------[]------[]------<>------[]------[]------[]------[]------[]------[]------[]------[]------<>------<>------[]------<>------[]------[]------[]----------
----------------[]------[]------[]------[]------[]------[]------[]------[]------[]------[]------[]------[]------[]------[]------[]------[]------[]------[]------[]------[]------[]------[]------[]------[]------[]----------
XXXXXXXXXXXXXXXXXXXXXXXXXXXXXXXXXXXXXXXXXXXXXXXXXXXXXXXXXXXXXXXXXXXXXXXXXXXXXXXXXXXXXXXXXXXXXXXXXXXXXXXXXXXXXXXXXXXXXXXXXXXXXXXXXXXXXXXXXXXXXXXXXXXXXXXXXXXXXXXXXXXXXXXXXXXXXXXXXXXXXXXXXXXXXXXXXXXXXXXXXXXXXXXXXXXXXXXXXXXX
