XXXXXXXXXXXXXXXXXXXXXXXXXXXXXXXXXXXXXXXXXXXXXXXXXXXXXXXXXXXXXXXXXXXXXXXXXXXXXXXXXXXXXXXXXXXXXXXXXXXXXXXXXXXXXXXXXXXXXXXXXXXXXXXXXXXXXXXXXXXXXXXXXXXXXXXXXXXXXXXXXXXXXXXXXXXXXXXXXXXXXXXXXXXXXXXXXXXXXXXXXXXXXXXXXXXXXXXXXXXX
----------------[]------[]------[]------[]------[]------[]------[]------[]------[]------[]------[]------[]------[]------[]------[]------[]------[]------[]------[]------[]------[]------[]------[]------[]------[]----------
----------------[]------[]------[]------[]------<>------[]------[]------[]------[]------<>------<>------[]------[]------[]------[]------<>------[]------[]------[]------[]------<>------<>------<>------<>------[]----------
----------------[]------<>------<>------<>--------------<>------[]------[]------[]----------------------[]------<>------[]------[]--------------[]------<>------<>------<>--------------------------------------<>----------
----------------[]----------------------------------------------[]------[]------<>----------------------[]--------------[]------[]--------------[]--------------------------------------------------------------------------
----------------[]----------------------------------------------[]------<>--------------<>------<>------<>--------------[]------[]------<>------<>------------------------------<>--------------<>------<>------------------
----------------[]------------------------------<>--------------[]----------------------[]------[]--------------<>------<>------[]------[]--------------<>----------------------[]------<>------[]------[]------------------
----------------<>----------------------<>------[]--------------<>----------------------[]------[]--------------[]--------------<>------[]--------------[]----------------------[]------[]------[]------[]------<>----------
----------------------------------------[]------[]------<>----------------------<>------[]------[]--------------[]----------------------[]--------------[]----------------------[]------[]------[]------[]------[]----------
----------------------------------------[]------[]------[]----------------------[]------[]------[]--------------[]----------------------[]--------------[]--------------<>------[]------[]------[]------[]------[]----------
----------------------------------------[]------[]------[]------<>--------------[]------[]------[]------<>------[]----------------------[]--------------[]------<>------[]------[]------[]------[]------[]------[]----------
----------------<>------<>------<>------[]------[]------[]------[]------<>------[]------[]------[]------[]------[]------<>------<>------[]------<>------[]------[]------[]------[]------[]------[]------[]------[]----------
----------------[]------[]------[]------[]------[]------[]------[]------[]------[]------[]------[]------[]------[]------[]------[]------[]------[]------[]------[]------[]------[]------[]------[]------[]------[]----------
XXXXXXXXXXXXXXXXXXXXXXXXXXXXXXXXXXXXXXXXXXXXXXXXXXXXXXXXXXXXXXXXXXXXXXXXXXXXXXXXXXXXXXXXXXXXXXXXXXXXXXXXXXXXXXXXXXXXXXXXXXXXXXXXXXXXXXXXXXXXXXXXXXXXXXXXXXXXXXXXXXXXXXXXXXXXXXXXXXXXXXXXXXXXXXXXXXXXXXXXXXXXXXXXXXXXXXXXXXXX
