XXXXXXXXXXXXXXXXXXXXXXXXXXXXXXXXXXXXXXXXXXXXXXXXXXXXXXXXXXXXXXXXXXXXXXXXXXXXXXXXXXXXXXXXXXXXXXXXXXXXXXXXXXXXXXXXXXXXXXXXXXXXXXXXXXXXXXXXXXXXXXXXXXXXXXXXXXXXXXXXXXXXXXXXXXXXXXXXXXXXXXXXXXXXXXXXXXXXXXXXXXXXXXXXXXXXXXXXXXXX
----------------[]------[]------[]------[]------[]------[]------[]------[]------[]------[]------[]------[]------[]------[]------[]------[]------[]------[]------[]------[]------[]------[]------[]------[]------[]----------
----------------[]------[]------[]------[]------<>------[]------<>------[]------[]------[]------[]------[]------[]------<>------<>------<>------[]------<>------[]------[]------[]------[]------<>------[]------<>----------
----------------[]------[]------[]------[]--------------<>--------------<>------[]------[]------[]------[]------[]------------------------------<>--------------<>------<>------[]------<>--------------[]------------------
----------------<>------[]------<>------[]--------------------------------------[]------[]------[]------[]------[]--------------------------------------------------------------<>----------------------[]------------------
------------------------[]--------------[]------<>--------------<>--------------[]------[]------[]------[]------[]--------------------------------------------------------------------------------------[]------<>----------
------------------------<>--------------[]------[]--------------[]--------------[]------[]------<>------[]------[]----------------------------------------------<>------<>------------------------------[]------[]----------
----------------------------------------<>------[]------<>------[]--------------[]------<>--------------[]------<>----------------------------------------------[]------[]--------------<>--------------[]------[]----------
------------------------------------------------[]------[]------[]--------------<>----------------------<>----------------------------------------------<>------[]------[]------<>------[]------<>------<>------[]----------
----------------<>------------------------------[]------[]------[]------------------------------<>----------------------<>------<>----------------------[]------[]------[]------[]------[]------[]--------------[]----------
----------------[]------<>--------------<>------[]------[]------[]------<>----------------------[]--------------<>------[]------[]--------------<>------[]------[]------[]------[]------[]------[]--------------[]----------
----------------[]------[]------<>------[]------[]------[]------[]------[]------<>------<>------[]------<>------[]------[]------[]------<>------[]------[]------[]------[]------[]------[]------[]------<>------[]----------
----------------[]------[]------[]------[]------[]------[]------[]------[]------[]------[]------[]------[]------[]------[]------[]------[]------[]------[]------[]------[]------[]------[]------[]------[]------[]----------
XXXXXXXXXXXXXXXXXXXXXXXXXXXXXXXXXXXXXXXXXXXXXXXXXXXXXXXXXXXXXXXXXXXXXXXXXXXXXXXXXXXXXXXXXXXXXXXXXXXXXXXXXXXXXXXXXXXXXXXXXXXXXXXXXXXXXXXXXXXXXXXXXXXXXXXXXXXXXXXXXXXXXXXXXXXXXXXXXXXXXXXXXXXXXXXXXXXXXXXXXXXXXXXXXXXXXXXXXXXX
