XXXXXXXXXXXXXXXXXXXXXXXXXXXXXXXXXXXXXXXXXXXXXXXXXXXXXXXXXXXXXXXXXXXXXXXXXXXXXXXXXXXXXXXXXXXXXXXXXXXXXXXXXXXXXXXXXXXXXXXXXXXXXXXXXXXXXXXXXXXXXXXXXXXXXXXXXXXXXXXXXXXXXXXXXXXXXXXXXXXXXXXXXXXXXXXXXXXXXXXXXXXXXXXXXXXXXXXXXXXX
----------------[]------[]------[]------[]------[]------[]------[]------[]------[]------[]------[]------[]------[]------[]------[]------[]------[]------[]------[]------[]------[]------[]------[]------[]------[]----------
----------------[]------[]------[]------[]------[]------<>------[]------[]------[]------<>------[]------<>------[]------[]------[]------<>------<>------[]------[]------[]------<>------[]------<>------[]------[]----------
----------------<>------<>------[]------[]------[]--------------<>------[]------[]--------------[]--------------[]------[]------<>----------------------[]------<>------<>--------------[]--------------<>------[]----------
--------------------------------<>------<>------[]----------------------[]------[]--------------<>--------------[]------<>------------------------------<>------------------------------<>----------------------[]----------
------------------------------------------------<>------<>--------------[]------<>------------------------------[]----------------------<>------------------------------------------------------<>--------------[]----------
--------------------------------------------------------[]--------------<>------------------------------<>------[]----------------------[]------<>----------------------<>------<>--------------[]--------------[]----------
--------------------------------------------------------[]------<>--------------------------------------[]------<>----------------------[]------[]------<>--------------[]------[]--------------[]--------------<>----------
----------------------------------------<>------<>------[]------[]------------------------------<>------[]--------------<>--------------[]------[]------[]--------------[]------[]------<>------[]--------------------------
----------------------------------------[]------[]------[]------[]--------------<>------<>------[]------[]--------------[]--------------[]------[]------[]------<>------[]------[]------[]------[]--------------------------
----------------<>------<>------<>------[]------[]------[]------[]------<>------[]------[]------[]------[]------<>------[]------<>------[]------[]------[]------[]------[]------[]------[]------[]------<>------<>----------
----------------[]------[]------[]------[]------[]------[]------[]------[]------[]------[]------[]------[]------[]------[]------[]------[]------[]------[]------[]------[]------[]------[]------[]------[]------[]----------
----------------[]------[]------[]------[]------[]------[]------[]------[]------[]------[]------[]------[]------[]------[]------[]------[]------[]------[]------[]------[]------[]------[]------[]------[]------[]----------
XXXXXXXXXXXXXXXXXXXXXXXXXXXXXXXXXXXXXXXXXXXXXXXXXXXXXXXXXXXXXXXXXXXXXXXXXXXXXXXXXXXXXXXXXXXXXXXXXXXXXXXXXXXXXXXXXXXXXXXXXXXXXXXXXXXXXXXXXXXXXXXXXXXXXXXXXXXXXXXXXXXXXXXXXXXXXXXXXXXXXXXXXXXXXXXXXXXXXXXXXXXXXXXXXXXXXXXXXXXX
