XXXXXXXXXXXXXXXXXXXXXXXXXXXXXXXXXXXXXXXXXXXXXXXXXXXXXXXXXXXXXXXXXXXXXXXXXXXXXXXXXXXXXXXXXXXXXXXXXXXXXXXXXXXXXXXXXXXXXXXXXXXXXXXXXXXXXXXXXXXXXXXXXXXXXXXXXXXXXXXXXXXXXXXXXXXXXXXXXXXXXXXXXXXXXXXXXXXXXXXXXXXXXXXXXXXXXXXXXXXX
----------------[]------[]------[]------[]------[]------[]------[]------[]------[]------[]------[]------[]------[]------[]------[]------[]------[]------[]------[]------[]------[]------[]------[]------[]------[]----------
----------------[]------[]------[]------[]------<>------[]------[]------[]------<>------[]------<>------[]------[]------[]------[]------[]------[]------<>------[]------[]------<>------[]------[]------[]------[]----------
----------------[]------[]------[]------<>--------------[]------[]------[]--------------<>--------------[]------[]------<>------<>------<>------<>--------------<>------<>--------------<>------<>------<>------<>----------
----------------[]------<>------[]----------------------<>------[]------[]------------------------------[]------[]----------------------------------------------------------------------------------------------------------
----------------[]--------------[]------------------------------<>------[]------<>----------------------[]------[]--------------------------------------<>------------------------------------------------------------------
----------------[]--------------<>--------------<>----------------------<>------[]--------------<>------<>------[]------<>------<>----------------------[]------------------------------------------------------------------
----------------<>------------------------------[]------------------------------[]--------------[]--------------[]------[]------[]------<>------<>------[]------------------------------------------------------------------
------------------------------------------------[]------------------------------[]--------------[]--------------<>------[]------[]------[]------[]------[]--------------<>--------------------------------------------------
----------------------------------------<>------[]------<>--------------<>------[]--------------[]----------------------[]------[]------[]------[]------[]------<>------[]----------------------<>--------------<>----------
--------------------------------<>------[]------[]------[]--------------[]------[]------<>------[]----------------------[]------[]------[]------[]------[]------[]------[]------<>------<>------[]--------------[]----------
----------------<>------<>------[]------[]------[]------[]------<>------[]------[]------[]------[]------<>------<>------[]------[]------[]------[]------[]------[]------[]------[]------[]------[]------<>------[]----------
----------------[]------[]------[]------[]------[]------[]------[]------[]------[]------[]------[]------[]------[]------[]------[]------[]------[]------[]------[]------[]------[]------[]------[]------[]------[]----------
XXXXXXXXXXXXXXXXXXXXXXXXXXXXXXXXXXXXXXXXXXXXXXXXXXXXXXXXXXXXXXXXXXXXXXXXXXXXXXXXXXXXXXXXXXXXXXXXXXXXXXXXXXXXXXXXXXXXXXXXXXXXXXXXXXXXXXXXXXXXXXXXXXXXXXXXXXXXXXXXXXXXXXXXXXXXXXXXXXXXXXXXXXXXXXXXXXXXXXXXXXXXXXXXXXXXXXXXXXXX
