XXXXXXXXXXXXXXXXXXXXXXXXXXXXXXXXXXXXXXXXXXXXXXXXXXXXXXXXXXXXXXXXXXXXXXXXXXXXXXXXXXXXXXXXXXXXXXXXXXXXXXXXXXXXXXXXXXXXXXXXXXXXXXXXXXXXXXXXXXXXXXXXXXXXXXXXXXXXXXXXXXXXXXXXXXXXXXXXXXXXXXXXXXXXXXXXXXXXXXXXXXXXXXXXXXXXXXXXXXXX
----------------[]------[]------[]------[]------[]------[]------[]------[]------[]------[]------[]------[]------[]------[]------[]------[]------[]------[]------[]------[]------[]------[]------[]------[]------[]----------
----------------[]------<>------[]------<>------<>------[]------[]------<>------[]------<>------[]------<>------[]------<>------<>------[]------<>------<>------<>------[]------[]------[]------[]------<>------<>----------
----------------<>--------------[]----------------------<>------[]--------------<>--------------[]--------------<>----------------------[]------------------------------[]------<>------<>------[]--------------------------
--------------------------------<>------------------------------[]------------------------------<>--------------------------------------[]------------------------------[]----------------------[]--------------------------
------------------------<>--------------<>------<>--------------[]----------------------<>--------------<>--------------<>--------------[]------------------------------<>----------------------[]------<>------<>----------
------------------------[]--------------[]------[]------<>------<>----------------------[]--------------[]------<>------[]--------------[]--------------<>--------------------------------------<>------[]------[]----------
------------------------[]--------------[]------[]------[]------------------------------[]------<>------[]------[]------[]--------------[]--------------[]------<>----------------------<>--------------[]------[]----------
----------------<>------[]------<>------[]------[]------[]------------------------------[]------[]------[]------[]------[]--------------<>------<>------[]------[]----------------------[]--------------[]------[]----------
----------------[]------[]------[]------[]------[]------[]------------------------------[]------[]------[]------[]------[]----------------------[]------[]------[]--------------<>------[]------<>------[]------[]----------
----------------[]------[]------[]------[]------[]------[]------<>--------------<>------[]------[]------[]------[]------[]------<>--------------[]------[]------[]--------------[]------[]------[]------[]------[]----------
----------------[]------[]------[]------[]------[]------[]------[]------<>------[]------[]------[]------[]------[]------[]------[]------<>------[]------[]------[]------<>------[]------[]------[]------[]------[]----------
----------------[]------[]------[]------[]------[]------[]------[]------[]------[]------[]------[]------[]------[]------[]------[]------[]------[]------[]------[]------[]------[]------[]------[]------[]------[]----------
XXXXXXXXXXXXXXXXXXXXXXXXXXXXXXXXXXXXXXXXXXXXXXXXXXXXXXXXXXXXXXXXXXXXXXXXXXXXXXXXXXXXXXXXXXXXXXXXXXXXXXXXXXXXXXXXXXXXXXXXXXXXXXXXXXXXXXXXXXXXXXXXXXXXXXXXXXXXXXXXXXXXXXXXXXXXXXXXXXXXXXXXXXXXXXXXXXXXXXXXXXXXXXXXXXXXXXXXXXXX
